EnrollmentNo,sub1,sub2,sub3,sub4,sub5,Total,Percentage
E6928,89,95,99,89,100,472,95
E5898,99,84,92,96,92,463,93
E5833,87,92,99,82,97,457,92
E6946,100,78,99,84,96,457,92
E7047,99,72,98,93,94,456,92
E5399,98,81,79,98,99,455,91
E8655,100,88,95,78,94,455,91
E2321,86,94,89,85,100,454,91
E8393,95,99,84,89,87,454,91
E7451,98,97,59,99,100,453,91
E5853,97,98,100,72,86,453,91
E2136,90,93,84,93,92,452,91
E3479,90,89,85,88,100,452,91
E2555,93,89,92,85,91,450,90
E6220,96,70,99,91,94,450,90
E4048,100,100,80,71,98,449,90
E9254,92,96,89,84,88,449,90
E8850,78,92,99,80,99,448,90
E8758,99,96,76,91,85,447,90
E4348,88,96,67,100,96,447,90
E5862,99,97,86,91,74,447,90
E9945,92,94,86,86,89,447,90
E2366,95,78,93,99,82,447,90
E3955,100,98,88,88,72,446,90
E1293,70,95,90,100,91,446,90
E7094,87,99,88,97,75,446,90
E1815,82,73,98,100,93,446,90
E7631,96,93,89,72,96,446,90
E7284,83,88,100,77,98,446,90
E5119,98,98,93,93,64,446,90
E9198,94,98,75,81,97,445,89
E9046,75,100,80,90,100,445,89
E6011,97,77,100,71,100,445,89
E3837,65,93,88,100,99,445,89
E4637,94,91,80,81,99,445,89
E5744,96,85,72,92,99,444,89
E7079,78,75,99,93,99,444,89
E3301,84,92,100,71,96,443,89
E8012,92,95,82,93,81,443,89
E0877,83,68,97,97,98,443,89
E3126,84,99,94,70,96,443,89
E9176,98,65,100,98,82,443,89
E8527,77,98,85,85,97,442,89
E0073,97,64,87,98,96,442,89
E9801,88,100,99,97,58,442,89
E5925,94,98,93,95,60,440,88
E5537,76,88,77,99,100,440,88
E3145,85,88,100,89,78,440,88
E8709,96,79,78,93,94,440,88
E1244,94,82,69,100,95,440,88
E2028,67,95,94,95,88,439,88
E9950,81,95,94,69,100,439,88
E6896,97,66,89,97,90,439,88
E9500,89,87,84,84,94,438,88
E8798,84,89,81,88,96,438,88
E1171,90,82,93,82,91,438,88
E3392,99,89,100,95,55,438,88
E8966,95,95,58,93,97,438,88
E1601,98,97,82,78,83,438,88
E3514,94,78,66,99,100,437,88
E4156,95,76,96,79,91,437,88
E2563,87,86,71,94,99,437,88
E2827,81,84,84,88,100,437,88
E3884,72,94,83,89,99,437,88
E4689,89,96,81,83,88,437,88
E3561,76,88,88,90,95,437,88
E5069,76,95,83,96,87,437,88
E2595,91,94,78,74,99,436,88
E9197,100,70,84,95,87,436,88
E7654,91,88,94,98,65,436,88
E5429,100,49,97,97,93,436,88
E5746,95,94,61,91,95,436,88
E7370,90,76,96,92,82,436,88
E9659,92,72,100,99,73,436,88
E3815,87,99,99,90,60,435,87
E3637,87,97,86,89,76,435,87
E6758,88,82,94,72,99,435,87
E6332,88,76,91,98,82,435,87
E2796,87,97,99,79,73,435,87
E9040,100,90,100,87,58,435,87
E8535,78,98,79,95,85,435,87
E2455,94,82,84,95,80,435,87
E9771,93,97,82,82,80,434,87
E1560,72,95,94,74,99,434,87
E0704,91,90,84,72,97,434,87
E8196,88,96,85,82,82,433,87
E4367,79,91,98,74,91,433,87
E8584,75,100,89,98,71,433,87
E1107,78,72,95,99,89,433,87
E8101,96,76,90,100,70,432,87
E1929,90,87,89,82,84,432,87
E2130,71,95,94,73,99,432,87
E0663,94,91,99,59,88,431,87
E9301,69,97,98,81,86,431,87
E6583,94,56,96,91,94,431,87
E0571,71,100,92,82,86,431,87
E6366,61,97,97,98,78,431,87
E8316,98,92,50,100,91,431,87
E3529,82,80,74,98,97,431,87
E4081,81,98,54,99,99,431,87
E3126,95,88,59,97,92,431,87
E0082,70,97,78,90,96,431,87
E7801,96,97,55,95,88,431,87
E2917,82,85,95,73,96,431,87
E0233,58,100,91,98,83,430,86
E7439,89,100,79,73,89,430,86
E7006,98,85,99,63,85,430,86
E5280,96,84,74,93,83,430,86
E2461,69,94,90,88,89,430,86
E2746,89,88,73,97,83,430,86
E7733,91,100,89,60,90,430,86
E9593,84,94,71,87,94,430,86
E9486,87,99,98,100,45,429,86
E8847,95,72,77,87,98,429,86
E5344,100,57,95,89,88,429,86
E7919,59,100,90,80,100,429,86
E3415,86,65,98,96,84,429,86
E7557,73,86,80,93,97,429,86
E3502,96,81,64,100,88,429,86
E7537,75,81,99,98,76,429,86
E3152,97,84,65,94,89,429,86
E7430,91,95,71,76,96,429,86
E4601,63,89,94,86,97,429,86
E2901,68,100,86,87,88,429,86
E0459,100,84,89,93,63,429,86
E6529,80,74,94,88,93,429,86
E2883,82,92,99,91,64,428,86
E2876,89,82,92,85,80,428,86
E0780,83,86,94,77,88,428,86
E1906,72,99,64,99,94,428,86
E3998,92,78,87,88,83,428,86
E0919,95,79,81,85,88,428,86
E6940,94,84,96,76,78,428,86
E1181,87,95,93,64,89,428,86
E9558,83,68,92,98,87,428,86
E8209,78,79,96,85,89,427,86
E2351,49,97,96,97,88,427,86
E4817,86,84,98,89,70,427,86
E8686,76,81,89,92,89,427,86
E8647,97,89,71,74,96,427,86
E3449,89,88,80,74,96,427,86
E0636,85,88,100,77,77,427,86
E9676,98,96,79,59,94,426,86
E9730,88,88,75,81,94,426,86
E0030,76,91,86,78,95,426,86
E2733,99,41,92,97,97,426,86
E2235,81,100,100,69,76,426,86
E3044,96,94,55,93,88,426,86
E3609,72,100,98,58,98,426,86
E2977,81,99,69,95,82,426,86
E7505,100,73,87,95,71,426,86
E0559,68,89,97,85,87,426,86
E2822,87,85,83,80,91,426,86
E6208,64,95,71,98,98,426,86
E7133,95,98,94,50,89,426,86
E1364,61,98,81,88,98,426,86
E1977,85,89,97,96,58,425,85
E4103,95,91,76,78,85,425,85
E5893,87,68,100,100,70,425,85
E6734,71,62,97,96,99,425,85
E4088,63,95,92,95,80,425,85
E1855,92,78,88,82,85,425,85
E7387,95,97,80,70,83,425,85
E7749,98,63,97,82,85,425,85
E7961,81,69,97,88,90,425,85
E4941,96,95,50,87,97,425,85
E8787,99,69,89,87,80,424,85
E4110,81,58,100,86,99,424,85
E9008,92,60,92,91,89,424,85
E2987,95,83,95,85,66,424,85
E3972,82,93,94,62,93,424,85
E8206,85,100,88,98,53,424,85
E5997,64,90,90,91,89,424,85
E0772,92,55,90,96,91,424,85
E1663,93,61,89,88,93,424,85
E6488,86,98,66,93,81,424,85
E7711,96,84,91,88,65,424,85
E6589,95,82,85,82,79,423,85
E7083,89,78,66,90,100,423,85
E3703,89,84,95,56,99,423,85
E3809,73,94,87,78,91,423,85
E0107,87,64,93,88,91,423,85
E4061,84,59,90,92,98,423,85
E0448,58,94,87,93,91,423,85
E8679,64,94,83,100,82,423,85
E7481,99,69,69,89,97,423,85
E0186,54,93,98,88,90,423,85
E5353,91,100,67,80,85,423,85
E8153,86,85,94,89,69,423,85
E5583,98,90,93,52,90,423,85
E7347,84,93,55,96,95,423,85
E8444,84,84,64,96,95,423,85
E0212,79,56,100,87,100,422,85
E0183,81,75,87,89,90,422,85
E0243,87,96,99,46,94,422,85
E6080,89,99,81,58,95,422,85
E2204,48,100,91,95,88,422,85
E2277,68,91,89,76,97,421,85
E5765,81,85,90,65,100,421,85
E1635,43,96,97,100,85,421,85
E2863,94,74,70,98,85,421,85
E1685,100,77,70,96,78,421,85
E4396,67,89,98,86,81,421,85
E4188,93,92,83,77,76,421,85
E3524,44,99,95,93,90,421,85
E5486,74,88,88,93,78,421,85
E1435,55,89,88,95,94,421,85
E2040,89,69,97,100,66,421,85
E6613,94,85,95,80,67,421,85
E7393,61,92,85,92,91,421,85
E2987,90,67,83,91,90,421,85
E8056,65,99,71,97,89,421,85
E0004,93,69,91,97,71,421,85
E1751,92,81,56,92,100,421,85
E6465,83,94,91,77,76,421,85
E9516,82,93,97,69,79,420,84
E8884,79,97,57,98,89,420,84
E8549,98,77,64,83,98,420,84
E5470,69,92,84,96,79,420,84
E2770,54,92,89,90,95,420,84
E4289,95,95,85,72,73,420,84
E7918,68,94,79,92,87,420,84
E7351,66,97,84,83,90,420,84
E4077,67,99,79,98,77,420,84
E5151,73,86,99,91,71,420,84
E6932,86,84,96,67,87,420,84
E1932,93,63,91,98,75,420,84
E2031,85,88,89,84,73,419,84
E8358,68,87,92,84,88,419,84
E7857,87,76,93,87,76,419,84
E8848,97,100,86,56,80,419,84
E6963,99,69,70,83,98,419,84
E1131,84,92,79,79,85,419,84
E9315,70,92,98,91,68,419,84
E2847,97,90,96,89,47,419,84
E2468,89,90,69,82,89,419,84
E6701,86,53,98,96,86,419,84
E3268,72,79,80,98,90,419,84
E7635,58,96,70,95,100,419,84
E9294,100,93,98,58,69,418,84
E4274,82,92,98,98,48,418,84
E9576,100,63,99,60,96,418,84
E8080,95,74,93,99,57,418,84
E3193,82,92,61,96,87,418,84
E5458,87,64,94,98,75,418,84
E8897,93,98,74,83,70,418,84
E8328,92,100,88,98,40,418,84
E3576,72,88,88,100,70,418,84
E5564,90,61,97,71,99,418,84
E5743,46,99,83,92,98,418,84
E0986,55,100,73,95,95,418,84
E3279,84,83,84,81,86,418,84
E8885,97,81,65,76,99,418,84
E5003,99,89,87,68,75,418,84
E6710,73,83,95,83,84,418,84
E2055,71,88,85,89,85,418,84
E7849,69,91,82,77,99,418,84
E9290,91,100,81,98,48,418,84
E2956,99,95,62,92,70,418,84
E4074,80,76,97,91,74,418,84
E2653,86,86,84,79,83,418,84
E8912,93,76,96,68,85,418,84
E1282,76,100,84,99,58,417,84
E0226,83,78,72,100,84,417,84
E3772,94,94,99,55,75,417,84
E1842,82,100,91,52,92,417,84
E4461,72,88,86,91,80,417,84
E7306,80,88,85,76,88,417,84
E7791,74,86,93,93,71,417,84
E4820,84,60,97,87,89,417,84
E4143,100,55,74,100,88,417,84
E6610,62,91,84,95,85,417,84
E8763,62,70,95,96,94,417,84
E9753,92,83,95,57,89,416,84
E1770,100,94,86,70,66,416,84
E9273,91,86,100,44,95,416,84
E7367,56,97,90,88,85,416,84
E8877,95,74,61,89,97,416,84
E1643,74,98,97,93,54,416,84
E3796,90,70,82,82,92,416,84
E7256,68,94,89,89,76,416,84
E5820,98,43,91,86,98,416,84
E6294,89,92,81,97,57,416,84
E1451,98,80,51,91,96,416,84
E6933,80,91,95,88,62,416,84
E4888,89,89,87,93,58,416,84
E3193,60,94,70,98,94,416,84
E3437,84,94,100,63,75,416,84
E6493,63,86,96,80,91,416,84
E5291,92,95,43,88,98,416,84
E7880,54,93,74,99,95,415,83
E8143,100,82,76,58,99,415,83
E7492,94,72,75,89,85,415,83
E1124,93,96,74,90,62,415,83
E3596,69,85,74,98,89,415,83
E8125,68,83,73,99,92,415,83
E6249,91,94,99,88,43,415,83
E6763,85,78,93,90,69,415,83
E9423,67,91,88,77,92,415,83
E0126,71,76,94,92,82,415,83
E7527,94,96,94,72,59,415,83
E1173,64,92,86,94,79,415,83
E8682,77,100,60,84,94,415,83
E4619,97,76,88,56,97,414,83
E8686,96,96,75,65,82,414,83
E0639,84,88,93,74,75,414,83
E9751,87,79,69,90,89,414,83
E9618,93,92,87,95,47,414,83
E3054,44,92,97,84,97,414,83
E7506,75,91,65,86,97,414,83
E1197,61,75,97,82,99,414,83
E8672,82,88,97,90,57,414,83
E7196,91,77,100,72,74,414,83
E6697,73,79,64,100,98,414,83
E4749,89,100,62,94,69,414,83
E7501,90,84,75,94,71,414,83
E9000,67,95,90,82,79,413,83
E2613,70,98,66,98,81,413,83
E3076,95,80,96,48,94,413,83
E4046,83,82,100,61,87,413,83
E1064,74,93,80,84,82,413,83
E4987,89,94,84,98,48,413,83
E4329,65,61,93,98,96,413,83
E8855,91,72,96,74,80,413,83
E6344,94,43,97,85,94,413,83
E1241,97,50,100,75,91,413,83
E0797,80,86,94,89,64,413,83
E6511,78,98,89,67,81,413,83
E4529,96,64,75,84,94,413,83
E1859,93,74,65,88,93,413,83
E2327,64,97,75,94,83,413,83
E1645,97,89,93,58,76,413,83
E7262,96,100,72,57,88,413,83
E2967,84,87,63,80,98,412,83
E2806,67,100,88,77,80,412,83
E4509,89,98,67,85,73,412,83
E5753,87,88,73,95,69,412,83
E5970,97,100,68,61,86,412,83
E7057,100,74,80,66,92,412,83
E5888,96,86,72,60,98,412,83
E5936,77,83,96,100,56,412,83
E2228,76,43,98,100,95,412,83
E8950,87,75,64,86,100,412,83
E9987,72,100,66,81,93,412,83
E5491,67,89,92,83,81,412,83
E8487,63,89,74,99,87,412,83
E0397,55,100,84,89,83,411,83
E7686,69,85,87,98,72,411,83
E2854,75,94,84,99,59,411,83
E9701,72,92,62,85,100,411,83
E6079,78,56,91,92,94,411,83
E6149,100,65,87,92,67,411,83
E9408,93,68,78,79,93,411,83
E5217,81,79,70,93,88,411,83
E9472,54,96,94,86,81,411,83
E1433,79,74,75,100,83,411,83
E2040,93,89,58,82,89,411,83
E5228,89,84,98,87,53,411,83
E5902,91,69,89,74,88,411,83
E3630,89,82,98,89,53,411,83
E6840,91,90,95,60,75,411,83
E0447,88,56,91,80,96,411,83
E5768,93,84,54,81,99,411,83
E8486,75,90,78,81,87,411,83
E3840,89,98,62,83,79,411,83
E6107,73,70,100,88,79,410,82
E4811,76,69,95,71,99,410,82
E4404,93,83,90,56,88,410,82
E1306,49,96,70,100,95,410,82
E1316,96,64,73,86,91,410,82
E0060,62,65,95,99,89,410,82
E8699,57,85,77,91,100,410,82
E1468,93,50,87,90,90,410,82
E5212,60,76,96,86,92,410,82
E4110,80,75,98,87,70,410,82
E9720,82,85,94,70,79,410,82
E3949,62,91,82,98,77,410,82
E0977,97,47,98,87,81,410,82
E3903,95,65,81,82,87,410,82
E8947,84,92,78,92,64,410,82
E4202,60,96,81,78,95,410,82
E9022,87,63,99,60,100,409,82
E3496,77,71,87,84,90,409,82
E6052,84,64,100,61,100,409,82
E6077,79,95,70,79,86,409,82
E5082,48,80,91,93,97,409,82
E0569,87,77,65,85,95,409,82
E8680,93,40,99,88,89,409,82
E4295,83,91,77,96,62,409,82
E3470,97,63,86,77,86,409,82
E5396,74,92,82,69,92,409,82
E3753,100,64,91,88,66,409,82
E7897,85,63,84,95,82,409,82
E0587,77,91,54,95,92,409,82
E4737,61,82,89,78,99,409,82
E9674,66,68,88,90,97,409,82
E2745,74,78,95,64,98,409,82
E2661,100,88,65,59,97,409,82
E9421,81,89,89,76,74,409,82
E4319,69,94,66,98,82,409,82
E3489,75,84,82,97,71,409,82
E7857,67,89,67,90,96,409,82
E0075,85,86,74,78,86,409,82
E7515,87,61,79,99,83,409,82
E4846,86,79,100,45,99,409,82
E9019,98,99,45,99,68,409,82
E2403,75,84,72,99,79,409,82
E2608,81,84,91,53,100,409,82
E6689,87,51,89,83,98,408,82
E1410,97,93,94,51,73,408,82
E0338,97,81,89,69,72,408,82
E4223,88,87,76,89,68,408,82
E5023,97,69,88,91,63,408,82
E0460,61,82,99,100,66,408,82
E7335,81,60,89,94,84,408,82
E2193,99,87,57,92,73,408,82
E3470,79,81,88,73,87,408,82
E7273,84,75,91,73,85,408,82
E9632,68,66,80,100,94,408,82
E4913,100,97,90,75,46,408,82
E9392,82,94,43,91,98,408,82
E0383,86,70,72,91,89,408,82
E0661,97,47,81,87,96,408,82
E9324,84,95,53,77,99,408,82
E9548,87,85,85,79,72,408,82
E9402,42,100,96,91,79,408,82
E5752,100,58,73,94,83,408,82
E0369,98,93,79,77,61,408,82
E3507,100,73,75,78,82,408,82
E7053,56,95,65,96,96,408,82
E6827,81,91,70,75,91,408,82
E7677,93,100,84,91,40,408,82
E0295,79,55,75,99,99,407,82
E2882,72,75,73,96,91,407,82
E1142,96,100,73,84,54,407,82
E2523,93,80,76,60,98,407,82
E8237,80,83,94,100,50,407,82
E9776,71,64,91,94,87,407,82
E6652,95,71,74,89,78,407,82
E7504,86,99,51,81,90,407,82
E3169,49,90,98,77,93,407,82
E6221,63,79,91,75,99,407,82
E7152,76,98,93,99,41,407,82
E2523,74,98,91,64,80,407,82
E2278,100,92,90,46,79,407,82
E5220,93,72,71,99,72,407,82
E9188,85,76,92,91,63,407,82
E3241,81,92,63,77,94,407,82
E3600,93,81,95,50,88,407,82
E8968,72,70,93,80,92,407,82
E3673,97,73,65,80,92,407,82
E8115,67,80,93,81,86,407,82
E0772,94,74,58,88,93,407,82
E4518,88,52,97,95,75,407,82
E1966,88,75,75,89,79,406,82
E2824,99,96,62,72,77,406,82
E4016,53,84,81,88,100,406,82
E3795,93,98,55,68,92,406,82
E1291,74,98,72,94,68,406,82
E3552,88,85,81,60,92,406,82
E5588,90,86,95,63,72,406,82
E1275,77,100,96,50,83,406,82
E8805,47,79,99,100,81,406,82
E0709,74,88,64,97,83,406,82
E4775,55,93,94,88,76,406,82
E8907,97,90,45,97,77,406,82
E1902,94,68,95,53,96,406,82
E3149,93,97,57,77,82,406,82
E4027,70,88,88,64,96,406,82
E7979,82,74,71,96,83,406,82
E0543,100,69,90,80,67,406,82
E6736,100,73,96,48,89,406,82
E7743,98,58,62,99,89,406,82
E3309,79,89,51,94,93,406,82
E7788,91,68,83,96,67,405,81
E1669,58,90,95,92,70,405,81
E5575,81,79,72,93,80,405,81
E7805,100,54,67,95,89,405,81
E4071,73,85,76,83,88,405,81
E4981,82,62,81,86,94,405,81
E9046,80,72,70,98,85,405,81
E4180,59,93,88,85,80,405,81
E1244,100,57,86,98,64,405,81
E1338,96,90,93,51,75,405,81
E2342,97,85,97,54,72,405,81
E7641,87,72,96,53,97,405,81
E6901,100,71,99,66,69,405,81
E4594,74,63,87,82,99,405,81
E1834,98,70,87,95,55,405,81
E5941,89,41,99,83,93,405,81
E8664,100,87,61,94,63,405,81
E1021,60,65,88,92,99,404,81
E5942,93,86,67,75,83,404,81
E9214,86,71,79,98,70,404,81
E9466,52,94,89,84,85,404,81
E7402,95,40,96,99,74,404,81
E8979,99,84,52,87,82,404,81
E8235,74,99,87,59,85,404,81
E4503,76,87,100,54,87,404,81
E2734,46,86,97,82,93,404,81
E1334,59,62,97,93,93,404,81
E1033,83,44,98,94,85,404,81
E2158,100,81,58,96,69,404,81
E4179,90,46,86,85,97,404,81
E5430,72,93,87,68,84,404,81
E9596,48,74,94,98,90,404,81
E9170,40,100,73,94,97,404,81
E9458,98,68,91,92,55,404,81
E7250,74,65,91,86,87,403,81
E0197,70,99,55,82,97,403,81
E5779,80,63,93,76,91,403,81
E2008,81,78,91,53,100,403,81
E2860,98,72,75,82,76,403,81
E1317,67,62,94,96,84,403,81
E3957,71,73,88,98,73,403,81
E8186,89,90,72,87,65,403,81
E5675,91,44,100,76,92,403,81
E7866,69,83,55,96,100,403,81
E5676,94,92,49,85,83,403,81
E8698,99,59,95,75,75,403,81
E8963,86,82,85,79,70,402,81
E2966,65,62,98,90,87,402,81
E1750,91,81,57,100,73,402,81
E1449,94,45,81,87,95,402,81
E4283,76,77,75,81,93,402,81
E2531,63,67,99,90,83,402,81
E7440,54,49,100,99,100,402,81
E8213,46,96,73,100,87,402,81
E1469,90,89,81,44,98,402,81
E6628,85,51,81,99,86,402,81
E5750,85,89,60,85,83,402,81
E7897,69,52,92,89,100,402,81
E8440,63,51,100,91,97,402,81
E6492,87,87,66,64,98,402,81
E0480,81,89,79,68,85,402,81
E0206,71,83,72,96,80,402,81
E1584,92,76,95,95,44,402,81
E4454,83,60,94,96,69,402,81
E9668,77,97,100,57,71,402,81
E3692,71,73,85,82,91,402,81
E3825,85,99,82,51,85,402,81
E2698,85,98,66,94,59,402,81
E4352,91,63,85,75,88,402,81
E7474,57,95,57,99,93,401,81
E4089,50,86,80,91,94,401,81
E4783,99,81,95,75,51,401,81
E0730,52,98,78,89,84,401,81
E4904,49,85,82,99,86,401,81
E1765,85,46,87,93,90,401,81
E6801,75,93,80,54,99,401,81
E2827,84,88,54,96,79,401,81
E3033,73,93,65,76,94,401,81
E3954,80,64,100,65,92,401,81
E7429,92,86,92,54,77,401,81
E3663,79,100,63,96,63,401,81
E6198,68,85,71,90,87,401,81
E4163,81,65,88,69,98,401,81
E0728,53,63,92,94,99,401,81
E6269,70,58,99,97,77,401,81
E4150,42,88,100,100,71,401,81
E3241,96,83,91,64,67,401,81
E5772,99,90,76,79,57,401,81
E0475,91,80,81,59,90,401,81
E8442,87,100,66,96,52,401,81
E4762,91,63,91,95,61,401,81
E9449,72,95,94,77,63,401,81
E9419,50,75,82,96,98,401,81
E6747,85,95,93,54,74,401,81
E0355,81,99,74,86,61,401,81
E7643,99,80,99,42,80,400,80
E1175,73,98,94,92,43,400,80
E1523,91,92,87,89,41,400,80
E2238,84,90,91,69,66,400,80
E0017,98,72,81,69,80,400,80
E5975,62,59,85,99,95,400,80
E3768,96,83,51,85,85,400,80
E0120,95,50,77,99,79,400,80
E2595,98,83,57,85,77,400,80
E7464,96,68,91,100,45,400,80
E5445,43,99,82,91,85,400,80
E7923,76,99,49,81,95,400,80
E9934,76,87,97,82,58,400,80
E0821,78,73,91,94,64,400,80
E4798,86,78,68,81,87,400,80
E1260,81,61,96,66,96,400,80
E6858,99,43,81,84,93,400,80
E8600,98,87,48,91,76,400,80
E5055,90,84,86,65,75,400,80
E7582,100,68,79,70,83,400,80
E0697,97,58,100,60,84,399,80
E1380,98,90,59,83,69,399,80
E5381,98,91,65,69,76,399,80
E6691,49,88,75,88,99,399,80
E3053,56,88,78,88,89,399,80
E8213,80,68,91,61,99,399,80
E4921,97,71,62,87,82,399,80
E7829,98,47,85,77,92,399,80
E9009,52,95,100,57,95,399,80
E0626,89,47,98,75,90,399,80
E4710,85,87,74,82,71,399,80
E2637,70,94,94,100,41,399,80
E4056,52,96,98,85,68,399,80
E7141,59,75,96,69,100,399,80
E3790,67,61,99,92,80,399,80
E1167,42,91,92,94,80,399,80
E8183,51,96,68,96,88,399,80
E8051,68,94,98,72,67,399,80
E6594,90,93,95,42,79,399,80
E3356,77,95,63,97,67,399,80
E1046,67,63,100,96,73,399,80
E8641,77,78,77,73,94,399,80
E0714,96,92,69,52,90,399,80
E2310,92,100,97,46,63,398,80
E8448,60,86,88,66,98,398,80
E8430,77,92,79,90,60,398,80
E1077,100,94,45,59,100,398,80
E3013,77,100,69,81,71,398,80
E7848,61,85,86,72,94,398,80
E1442,79,56,72,93,98,398,80
E9967,86,65,67,84,96,398,80
E8190,59,90,64,98,87,398,80
E0393,100,85,55,63,95,398,80
E4312,62,87,97,94,58,398,80
E9985,92,81,66,61,98,398,80
E5655,77,77,87,69,88,398,80
E0390,86,99,52,69,92,398,80
E0230,93,77,42,87,99,398,80
E0173,95,93,51,90,69,398,80
E9135,86,68,81,95,68,398,80
E6222,100,48,74,97,79,398,80
E0723,74,67,84,89,84,398,80
E8149,94,60,56,97,91,398,80
E1973,81,45,83,100,89,398,80
E9373,60,69,89,87,93,398,80
E0879,43,95,74,91,95,398,80
E0995,71,86,63,77,100,397,80
E6889,59,84,94,72,88,397,80
E2129,61,100,65,80,91,397,80
E9445,53,99,94,52,99,397,80
E3440,77,45,100,89,86,397,80
E9769,81,97,96,79,44,397,80
E5922,81,78,55,86,97,397,80
E6238,85,77,72,80,83,397,80
E4070,89,86,94,51,77,397,80
E0032,92,94,73,60,78,397,80
E3387,56,79,77,90,95,397,80
E8555,74,100,72,51,100,397,80
E4232,76,88,93,57,83,397,80
E6802,90,64,81,94,68,397,80
E6509,81,98,95,70,53,397,80
E0811,78,87,84,78,70,397,80
E8124,57,94,82,81,83,397,80
E5323,91,98,93,71,44,397,80
E8156,72,95,70,67,93,397,80
E6820,100,54,99,55,89,397,80
E5333,77,79,85,64,92,397,80
E5236,91,80,72,75,79,397,80
E8296,99,52,86,69,91,397,80
E9994,84,60,100,79,74,397,80
E3064,51,80,85,100,80,396,80
E1107,99,58,74,81,84,396,80
E5557,58,84,68,86,100,396,80
E3311,88,89,76,98,45,396,80
E4140,64,91,82,76,83,396,80
E6440,91,63,67,100,75,396,80
E9311,80,67,88,66,95,396,80
E3924,81,84,75,92,64,396,80
E6183,50,90,96,61,99,396,80
E3762,47,90,69,94,96,396,80
E8382,68,52,98,85,93,396,80
E6974,54,94,93,90,65,396,80
E6677,46,88,84,78,100,396,80
E5932,87,77,69,80,83,396,80
E0766,74,100,89,92,41,396,80
E5999,76,96,63,70,91,396,80
E8410,79,70,91,89,67,396,80
E4341,66,63,97,95,75,396,80
E8850,78,77,69,94,78,396,80
E5111,94,47,84,92,79,396,80
E2487,86,94,73,67,76,396,80
E3185,70,64,83,88,91,396,80
E2163,80,49,86,88,93,396,80
E3554,76,67,84,72,96,395,79
E1117,65,78,97,70,85,395,79
E4148,64,86,100,62,83,395,79
E1366,82,41,98,96,78,395,79
E6476,70,94,94,69,68,395,79
E2534,82,91,81,67,74,395,79
E0587,60,69,99,79,88,395,79
E4807,60,100,94,57,84,395,79
E5931,59,84,84,83,85,395,79
E5328,86,55,84,90,80,395,79
E6580,63,100,82,72,78,395,79
E6652,85,100,70,93,47,395,79
E7394,56,94,82,96,67,395,79
E4456,75,69,78,87,86,395,79
E7986,93,63,86,77,76,395,79
E8465,78,85,79,79,74,395,79
E9002,75,90,60,89,81,395,79
E7542,92,66,70,74,93,395,79
E3866,72,91,97,51,84,395,79
E4998,74,82,83,57,99,395,79
E6305,81,63,69,93,89,395,79
E7763,84,73,91,99,47,394,79
E7327,76,98,73,69,78,394,79
E4747,60,90,74,79,91,394,79
E9455,78,85,63,71,97,394,79
E1156,100,99,72,70,53,394,79
E2355,96,43,95,65,95,394,79
E3691,73,79,74,70,98,394,79
E2137,100,95,70,79,50,394,79
E6615,85,87,84,67,71,394,79
E0967,96,63,79,61,95,394,79
E2895,86,71,51,95,91,394,79
E2686,86,86,48,82,92,394,79
E6928,96,99,88,56,55,394,79
E9732,93,42,83,90,86,394,79
E8391,55,89,68,88,94,394,79
E7537,71,94,75,85,69,394,79
E3020,100,42,93,73,86,394,79
E1426,56,84,76,81,97,394,79
E7525,98,46,94,69,87,394,79
E3375,76,55,97,92,74,394,79
E5824,85,70,95,94,49,393,79
E6851,77,85,95,40,96,393,79
E4286,49,95,93,65,91,393,79
E1718,58,72,77,98,88,393,79
E9490,84,67,90,96,56,393,79
E7413,98,62,89,56,88,393,79
E3024,71,98,77,77,70,393,79
E3779,70,100,75,55,93,393,79
E3919,68,95,96,53,81,393,79
E8010,91,87,96,75,44,393,79
E0666,93,66,93,65,76,393,79
E5999,73,74,95,88,63,393,79
E4971,81,95,90,55,72,393,79
E2160,97,100,48,70,78,393,79
E4836,79,99,55,72,88,393,79
E3901,84,40,93,90,86,393,79
E6181,99,97,68,44,85,393,79
E0572,85,81,96,71,60,393,79
E6922,48,87,99,80,79,393,79
E8647,69,64,91,90,79,393,79
E2836,82,79,91,64,77,393,79
E0753,63,91,94,56,89,393,79
E5495,89,44,72,88,100,393,79
E6313,78,62,78,99,76,393,79
E8183,81,86,63,82,81,393,79
E6302,90,63,92,96,52,393,79
E7651,91,69,94,44,95,393,79
E4643,80,94,79,69,70,392,79
E8288,80,75,84,90,63,392,79
E3889,47,96,82,72,95,392,79
E3686,76,81,90,58,87,392,79
E1845,97,55,71,73,96,392,79
E4355,96,97,78,44,77,392,79
E0639,95,42,94,90,71,392,79
E0635,81,88,76,63,84,392,79
E2989,93,95,57,62,85,392,79
E7434,94,54,88,72,84,392,79
E7118,71,74,52,96,99,392,79
E3208,47,99,97,84,65,392,79
E8923,84,59,88,88,73,392,79
E2087,88,89,68,61,86,392,79
E6748,86,44,93,90,79,392,79
E8595,87,91,90,65,59,392,79
E5378,89,79,80,57,87,392,79
E7604,81,62,71,82,96,392,79
E0068,58,79,79,93,83,392,79
E7651,66,56,94,92,84,392,79
E0808,74,92,85,65,76,392,79
E9468,56,73,81,85,97,392,79
E2967,87,66,87,71,81,392,79
E0403,83,56,83,86,84,392,79
E1754,93,69,95,64,71,392,79
E9537,86,75,67,80,84,392,79
E2351,76,89,79,54,94,392,79
E1833,54,53,90,94,100,391,79
E7038,76,77,95,84,59,391,79
E5150,76,94,79,44,98,391,79
E6649,77,67,81,67,99,391,79
E9409,91,71,62,97,70,391,79
E1986,47,85,97,78,84,391,79
E1755,64,96,80,81,70,391,79
E1744,97,52,100,44,98,391,79
E8014,90,79,88,44,90,391,79
E0784,90,97,84,69,51,391,79
E1071,75,90,41,93,92,391,79
E8623,96,54,68,73,100,391,79
E6147,93,90,57,67,84,391,79
E5375,90,62,88,73,78,391,79
E4370,58,70,100,92,71,391,79
E8706,98,65,91,54,83,391,79
E7908,79,65,63,89,95,391,79
E7203,93,84,72,96,46,391,79
E4648,100,47,85,64,95,391,79
E5344,66,83,72,83,87,391,79
E7359,85,54,78,76,98,391,79
E3328,92,77,100,43,79,391,79
E2901,81,48,83,88,91,391,79
E7773,49,94,98,95,55,391,79
E4371,64,76,87,100,64,391,79
E7806,66,100,61,89,75,391,79
E1551,99,78,76,53,85,391,79
E7142,97,66,96,52,80,391,79
E2867,83,66,60,87,95,391,79
E0090,71,58,91,85,86,391,79
E1252,77,60,96,98,59,390,78
E4985,97,80,63,77,73,390,78
E9087,90,58,86,83,73,390,78
E2454,67,96,78,87,62,390,78
E1682,67,82,74,89,78,390,78
E6470,99,63,98,47,83,390,78
E2623,88,84,74,55,89,390,78
E9853,73,95,98,40,84,390,78
E1415,81,59,86,91,73,390,78
E9077,58,90,84,66,92,390,78
E5262,86,99,80,80,45,390,78
E2566,99,99,43,52,97,390,78
E7176,95,63,62,86,84,390,78
E7686,77,98,69,88,58,390,78
E9486,74,69,94,66,87,390,78
E4473,49,99,52,93,97,390,78
E1017,90,88,43,78,91,390,78
E1272,70,88,86,58,88,390,78
E3374,98,51,77,94,70,390,78
E6467,54,45,94,99,97,389,78
E4977,56,100,100,48,85,389,78
E7438,65,99,91,83,51,389,78
E1281,92,63,63,72,99,389,78
E0867,47,99,76,70,97,389,78
E7889,89,53,97,65,85,389,78
E0951,70,100,97,82,40,389,78
E1495,88,76,100,80,45,389,78
E2907,98,95,94,59,43,389,78
E1064,97,48,49,98,97,389,78
E3477,69,98,99,65,58,389,78
E3394,96,100,77,49,67,389,78
E6359,93,86,58,58,94,389,78
E3906,59,95,91,86,58,389,78
E3189,60,92,67,87,83,389,78
E5639,63,59,91,98,78,389,78
E1038,100,74,72,55,88,389,78
E7055,98,85,64,90,52,389,78
E8726,54,61,84,94,96,389,78
E2156,85,57,97,79,71,389,78
E1270,70,58,98,81,82,389,78
E3464,85,91,52,70,91,389,78
E0358,93,56,49,97,94,389,78
E1547,42,65,97,92,93,389,78
E4312,82,96,71,98,42,389,78
E4184,91,76,66,70,86,389,78
E4601,77,48,91,92,81,389,78
E5295,49,83,65,95,97,389,78
E7175,68,72,100,85,63,388,78
E2550,67,89,95,77,60,388,78
E8979,44,94,83,73,94,388,78
E2333,75,94,90,75,54,388,78
E7744,92,65,89,74,68,388,78
E4743,61,63,84,81,99,388,78
E7976,76,70,82,90,70,388,78
E5385,67,99,49,74,99,388,78
E7813,51,87,62,89,99,388,78
E7132,71,94,88,74,61,388,78
E9222,68,71,88,63,98,388,78
E9367,52,98,79,77,82,388,78
E3908,97,98,68,75,50,388,78
E8598,86,51,79,88,84,388,78
E7957,99,80,72,77,60,388,78
E6499,86,68,47,91,96,388,78
E4244,43,65,85,100,95,388,78
E7313,88,92,61,64,83,388,78
E8066,92,73,87,47,89,388,78
E6961,80,56,64,94,94,388,78
E6258,68,88,94,82,56,388,78
E8311,78,90,70,88,62,388,78
E9366,80,100,69,79,60,388,78
E1806,91,68,51,93,85,388,78
E7787,98,89,51,90,60,388,78
E8399,51,96,93,70,78,388,78
E7787,89,73,100,45,81,388,78
E1796,88,81,58,64,97,388,78
E9452,94,69,93,88,44,388,78
E5024,51,89,71,93,84,388,78
E3145,71,96,74,92,55,388,78
E1228,78,93,98,62,57,388,78
E8882,77,49,83,97,82,388,78
E8230,96,88,81,78,45,388,78
E0007,71,72,75,78,92,388,78
E1222,77,72,60,87,92,388,78
E3439,66,48,82,97,95,388,78
E7765,91,44,94,90,69,388,78
E0631,96,74,88,56,74,388,78
E1431,95,99,54,80,60,388,78
E7324,91,79,88,57,73,388,78
E1712,83,56,79,69,100,387,78
E8641,91,81,53,84,78,387,78
E8188,100,56,62,70,99,387,78
E3484,65,97,65,89,71,387,78
E5276,88,60,94,55,90,387,78
E0509,52,93,76,86,80,387,78
E2709,46,81,73,100,87,387,78
E6800,86,53,99,75,74,387,78
E4786,72,76,87,53,99,387,78
E6391,85,88,74,64,76,387,78
E8113,83,43,91,96,74,387,78
E3391,55,100,80,100,52,387,78
E2137,52,91,67,78,99,387,78
E8687,77,96,55,83,76,387,78
E9090,69,73,96,91,58,387,78
E0492,90,84,72,58,83,387,78
E8787,75,99,100,51,62,387,78
E1531,78,89,77,59,84,387,78
E5625,85,93,88,71,50,387,78
E0092,51,90,85,80,81,387,78
E1367,63,91,98,83,52,387,78
E2948,79,83,84,84,57,387,78
E4901,80,82,78,66,81,387,78
E1282,93,87,63,79,65,387,78
E1792,88,75,69,56,99,387,78
E4899,77,51,95,93,71,387,78
E4160,98,63,50,94,82,387,78
E8875,70,95,82,98,42,387,78
E9655,66,64,98,89,70,387,78
E6252,87,89,62,99,50,387,78
E9319,56,97,51,94,89,387,78
E0407,70,97,47,87,86,387,78
E4032,79,41,74,93,100,387,78
E7509,61,58,83,89,96,387,78
E2225,86,55,95,97,53,386,78
E3470,62,91,54,92,87,386,78
E2519,63,86,78,83,76,386,78
E4496,96,77,72,51,90,386,78
E8937,83,90,49,99,65,386,78
E4097,62,95,97,52,80,386,78
E0731,95,62,58,77,94,386,78
E4459,93,99,70,82,42,386,78
E9705,67,90,77,63,89,386,78
E6077,98,66,78,89,55,386,78
E7331,86,45,98,71,86,386,78
E2793,90,76,65,82,73,386,78
E7450,79,56,74,81,96,386,78
E2388,77,81,78,57,93,386,78
E0435,88,91,83,48,76,386,78
E3843,61,95,47,89,94,386,78
E0491,68,93,70,57,98,386,78
E8536,50,63,91,89,93,386,78
E3710,85,96,57,96,52,386,78
E5688,93,99,80,51,63,386,78
E5151,43,80,72,94,97,386,78
E2152,55,99,98,45,89,386,78
E5012,81,92,46,75,92,386,78
E0275,95,58,95,53,85,386,78
E9577,67,90,93,89,47,386,78
E6615,78,93,81,78,56,386,78
E1255,93,99,60,82,52,386,78
E4865,82,89,60,64,91,386,78
E2096,88,91,89,61,57,386,78
E2113,74,87,83,93,49,386,78
E7321,93,96,68,73,56,386,78
E6111,99,66,80,83,57,385,77
E6401,74,92,87,45,87,385,77
E0073,72,71,83,99,60,385,77
E0040,94,70,73,73,75,385,77
E1107,90,54,54,97,90,385,77
E3796,83,74,71,96,61,385,77
E6142,54,90,89,89,63,385,77
E5281,44,65,95,81,100,385,77
E5775,100,47,85,85,68,385,77
E1793,75,79,77,93,61,385,77
E4391,82,79,87,46,91,385,77
E1567,86,62,96,57,84,385,77
E6215,58,53,88,93,93,385,77
E8272,94,40,87,66,98,385,77
E5571,75,74,64,83,89,385,77
E2850,45,100,97,96,47,385,77
E8668,77,95,46,94,73,385,77
E3218,90,52,62,82,99,385,77
E4851,60,79,77,96,73,385,77
E6816,92,85,54,56,98,385,77
E2836,63,99,96,81,46,385,77
E1785,72,91,54,98,70,385,77
E8731,60,64,95,87,79,385,77
E8430,94,57,72,91,71,385,77
E8873,74,85,55,97,74,385,77
E7948,73,86,61,66,99,385,77
E6550,73,84,93,74,61,385,77
E0668,74,61,98,85,67,385,77
E5218,74,92,66,61,92,385,77
E0997,90,55,93,71,76,385,77
E3465,97,76,75,79,58,385,77
E7758,83,62,69,75,96,385,77
E3312,63,80,81,78,83,385,77
E6936,95,44,93,91,62,385,77
E1475,66,75,73,90,81,385,77
E8345,75,65,94,57,94,385,77
E3494,89,76,61,58,100,384,77
E2613,90,85,55,97,57,384,77
E8771,83,75,80,89,57,384,77
E8710,73,54,75,98,84,384,77
E0376,83,86,96,52,67,384,77
E6054,71,96,84,79,54,384,77
E3523,82,76,74,88,64,384,77
E9847,78,72,57,81,96,384,77
E0888,89,94,65,44,92,384,77
E4619,64,57,84,83,96,384,77
E5605,90,63,100,77,54,384,77
E7694,56,88,77,83,80,384,77
E3869,48,60,100,92,84,384,77
E5242,75,88,76,79,66,384,77
E2215,69,71,59,94,91,384,77
E3078,100,62,74,51,97,384,77
E1925,80,87,79,97,41,384,77
E9307,69,85,96,67,67,384,77
E3784,78,61,88,65,92,384,77
E4226,86,87,86,55,70,384,77
E7461,79,97,64,54,90,384,77
E7079,97,81,44,74,88,384,77
E0906,100,73,55,96,60,384,77
E0055,75,73,97,85,54,384,77
E0382,60,79,76,91,78,384,77
E9445,74,100,80,75,55,384,77
E0175,61,66,91,81,85,384,77
E3152,68,98,70,76,72,384,77
E8377,84,68,71,64,96,383,77
E1967,87,92,56,95,53,383,77
E1321,52,88,84,79,80,383,77
E1471,42,98,93,65,85,383,77
E9708,82,69,76,100,56,383,77
E1673,62,78,50,98,95,383,77
E3550,92,76,51,84,80,383,77
E2081,74,85,67,91,66,383,77
E8320,81,69,100,73,60,383,77
E5760,93,98,43,53,96,383,77
E0758,88,76,88,67,64,383,77
E8866,94,96,100,52,41,383,77
E8664,73,42,86,86,96,383,77
E7820,74,58,81,77,93,383,77
E3820,90,67,69,64,93,383,77
E5935,55,71,97,94,66,383,77
E9619,88,74,66,56,99,383,77
E8071,84,69,93,76,61,383,77
E7045,70,87,72,92,62,383,77
E0068,78,90,92,51,72,383,77
E3597,60,90,91,80,62,383,77
E6842,72,72,51,93,95,383,77
E8466,86,71,62,88,76,383,77
E0958,64,87,51,92,89,383,77
E8442,82,49,91,79,82,383,77
E3303,64,96,89,55,79,383,77
E5323,91,70,50,85,87,383,77
E6547,83,48,80,91,81,383,77
E3228,81,64,83,87,68,383,77
E1175,94,99,69,64,57,383,77
E7575,96,82,77,70,58,383,77
E2763,84,89,61,94,55,383,77
E1824,55,62,87,83,96,383,77
E0200,44,72,83,99,85,383,77
E3698,73,62,90,62,96,383,77
E1130,88,87,61,79,68,383,77
E8937,41,99,98,78,67,383,77
E6083,95,82,64,66,76,383,77
E4173,92,89,76,41,85,383,77
E0885,91,54,84,80,74,383,77
E2277,64,100,84,60,74,382,77
E5889,92,100,80,55,55,382,77
E4504,91,92,87,66,46,382,77
E6835,60,83,85,59,95,382,77
E2373,82,68,55,97,80,382,77
E3496,95,66,61,64,96,382,77
E7304,79,84,74,95,50,382,77
E8762,59,81,79,89,74,382,77
E7695,44,94,98,69,77,382,77
E6741,41,89,99,91,62,382,77
E0653,62,54,96,79,91,382,77
E1266,95,44,68,79,96,382,77
E6785,78,84,95,42,83,382,77
E7547,65,88,56,86,87,382,77
E3552,75,73,99,42,93,382,77
E1167,58,50,100,99,75,382,77
E5788,86,76,83,43,94,382,77
E9743,45,74,69,96,98,382,77
E2249,98,61,50,77,96,382,77
E2317,64,76,50,92,100,382,77
E6891,88,54,97,88,55,382,77
E9612,78,92,86,81,45,382,77
E5800,73,91,97,75,46,382,77
E4552,80,91,85,53,73,382,77
E7532,75,77,98,47,85,382,77
E4738,95,57,43,99,88,382,77
E3566,92,59,69,68,94,382,77
E3603,66,76,94,91,55,382,77
E9147,82,100,64,43,93,382,77
E2399,89,82,41,98,72,382,77
E9001,63,70,81,82,86,382,77
E6645,82,73,93,51,83,382,77
E3012,79,68,61,84,90,382,77
E4273,65,86,73,82,76,382,77
E2822,92,78,76,55,81,382,77
E1652,87,52,60,83,100,382,77
E3322,55,80,75,79,93,382,77
E5890,77,94,50,79,82,382,77
E8889,99,93,60,58,72,382,77
E0533,73,60,81,89,78,381,77
E2157,77,57,83,90,74,381,77
E1322,53,89,91,98,50,381,77
E9864,98,74,79,70,60,381,77
E3435,91,69,74,70,77,381,77
E8582,98,78,40,65,100,381,77
E0675,81,100,90,42,68,381,77
E5539,88,78,89,41,85,381,77
E0714,98,57,98,83,45,381,77
E4331,67,74,95,78,67,381,77
E1107,89,89,52,74,77,381,77
E9012,92,73,62,54,100,381,77
E3853,48,86,67,94,86,381,77
E1255,41,90,90,65,95,381,77
E1918,99,41,96,89,56,381,77
E0760,78,88,77,74,64,381,77
E3025,78,77,43,100,83,381,77
E9895,74,93,82,79,53,381,77
E2431,73,55,80,96,77,381,77
E1456,87,87,81,54,72,381,77
E5379,57,90,96,91,47,381,77
E1627,77,88,75,49,92,381,77
E5148,87,52,79,96,67,381,77
E4860,52,84,97,56,92,381,77
E5854,63,48,76,99,95,381,77
E3644,79,98,53,79,72,381,77
E2436,56,85,76,73,91,381,77
E1907,73,86,69,96,57,381,77
E1806,74,48,85,98,76,381,77
E2834,70,85,96,67,63,381,77
E7686,93,62,100,69,57,381,77
E3440,63,75,97,99,47,381,77
E7440,71,43,95,93,79,381,77
E4629,85,98,42,93,63,381,77
E8295,94,73,89,66,59,381,77
E8698,75,95,66,96,49,381,77
E5915,66,68,93,91,63,381,77
E6292,54,75,95,87,70,381,77
E3246,88,48,97,88,60,381,77
E4882,56,81,71,83,90,381,77
E2316,78,79,71,96,56,380,76
E0316,83,73,67,75,82,380,76
E8123,94,88,60,40,98,380,76
E8836,95,52,59,78,96,380,76
E9364,75,55,59,100,91,380,76
E9291,79,64,63,81,93,380,76
E0329,75,71,94,50,90,380,76
E5201,84,69,92,62,73,380,76
E0717,79,63,69,88,81,380,76
E1626,71,88,97,76,48,380,76
E3035,98,45,86,95,56,380,76
E4759,100,62,66,100,52,380,76
E7684,94,64,43,85,94,380,76
E3189,63,70,81,83,83,380,76
E9240,99,62,49,91,79,380,76
E3635,91,54,81,56,98,380,76
E3715,75,82,65,64,94,380,76
E8180,67,58,98,86,71,380,76
E9202,100,80,100,41,59,380,76
E2418,88,92,72,79,49,380,76
E8421,78,56,97,52,97,380,76
E5569,76,97,56,54,97,380,76
E2817,95,40,63,92,90,380,76
E9355,100,82,82,74,42,380,76
E2302,56,82,56,92,94,380,76
E8696,71,69,94,66,80,380,76
E8357,91,100,73,43,73,380,76
E0636,60,88,81,61,90,380,76
E6132,83,90,44,91,72,380,76
E8715,90,64,84,85,57,380,76
E6188,52,83,96,48,100,379,76
E6297,72,100,67,99,41,379,76
E4385,57,96,86,40,100,379,76
E4067,87,95,53,85,59,379,76
E5071,63,45,99,94,78,379,76
E3178,87,63,73,58,98,379,76
E7622,53,96,94,48,88,379,76
E6113,70,79,75,95,60,379,76
E2258,93,69,73,80,64,379,76
E7868,81,58,96,63,81,379,76
E4490,55,69,99,77,79,379,76
E2634,100,47,62,75,95,379,76
E6443,78,97,66,41,97,379,76
E5697,88,98,55,60,78,379,76
E4680,76,94,75,43,91,379,76
E0741,88,79,83,55,74,379,76
E2877,99,48,83,68,81,379,76
E7576,69,58,64,96,92,379,76
E8367,64,56,81,80,98,379,76
E7982,57,100,90,59,73,379,76
E1199,68,81,82,81,67,379,76
E2555,84,96,74,83,42,379,76
E8547,74,98,78,67,62,379,76
E9014,93,50,91,99,46,379,76
E3276,79,58,77,81,84,379,76
E1541,70,75,55,85,94,379,76
E3198,64,58,99,61,97,379,76
E8027,90,61,55,91,82,379,76
E7451,84,90,84,75,46,379,76
E4983,63,91,68,66,91,379,76
E8912,82,95,57,95,50,379,76
E2885,88,64,93,94,40,379,76
E5444,84,99,75,67,54,379,76
E4942,98,70,56,79,76,379,76
E4728,71,85,85,94,44,379,76
E7336,49,68,88,99,75,379,76
E6581,65,89,80,84,60,378,76
E0127,50,70,76,95,87,378,76
E2833,69,99,62,89,59,378,76
E4296,80,56,83,72,87,378,76
E9166,97,80,67,43,91,378,76
E4630,94,93,48,63,80,378,76
E4200,55,67,100,59,97,378,76
E3986,81,91,62,47,97,378,76
E1139,69,91,92,79,47,378,76
E4115,73,80,51,81,93,378,76
E6767,48,64,78,92,96,378,76
E4375,85,75,97,47,74,378,76
E2323,65,78,90,77,68,378,76
E2922,83,78,83,73,61,378,76
E9734,81,95,57,55,90,378,76
E2800,97,50,65,89,77,378,76
E6936,92,97,78,69,42,378,76
E9779,80,65,71,81,81,378,76
E6396,60,95,50,81,92,378,76
E1677,70,74,98,51,85,378,76
E4022,83,78,75,90,52,378,76
E7362,65,79,99,55,80,378,76
E9215,53,97,74,86,68,378,76
E7991,88,94,87,68,41,378,76
E5241,64,98,65,90,61,378,76
E1107,67,66,97,93,55,378,76
E2940,81,56,78,89,74,378,76
E9570,69,89,82,53,85,378,76
E8081,55,77,99,75,72,378,76
E5623,75,79,70,65,89,378,76
E4766,40,92,58,89,99,378,76
E1014,90,81,88,73,46,378,76
E7930,70,51,85,84,88,378,76
E3943,78,90,78,84,48,378,76
E9590,87,89,90,65,47,378,76
E6347,70,50,99,65,94,378,76
E6470,87,53,79,65,94,378,76
E2491,84,74,97,40,83,378,76
E9043,69,77,56,85,90,377,76
E0522,65,68,71,76,97,377,76
E2764,94,84,47,63,89,377,76
E8842,96,72,79,59,71,377,76
E0492,66,77,100,69,65,377,76
E5874,95,93,53,42,94,377,76
E8055,84,88,61,76,68,377,76
E3368,71,69,86,55,96,377,76
E0806,83,87,55,56,96,377,76
E6206,78,78,80,72,69,377,76
E9145,53,87,91,51,95,377,76
E9631,49,95,72,89,72,377,76
E4207,62,79,95,69,72,377,76
E9874,75,71,53,91,87,377,76
E9398,76,60,97,85,59,377,76
E6109,84,44,97,94,58,377,76
E7542,52,92,65,78,90,377,76
E8132,58,97,85,47,90,377,76
E6231,52,74,100,79,72,377,76
E0256,76,48,70,89,94,377,76
E5171,68,87,66,98,58,377,76
E5991,41,96,100,50,90,377,76
E6995,74,58,50,95,100,377,76
E2001,83,84,84,42,84,377,76
E9048,59,77,97,53,91,377,76
E8656,81,75,78,65,78,377,76
E3776,53,94,99,45,86,377,76
E8986,95,46,95,94,47,377,76
E5227,83,65,64,81,84,377,76
E0846,93,43,76,94,71,377,76
E3447,82,50,83,91,71,377,76
E1504,81,95,96,64,41,377,76
E4643,65,89,84,82,57,377,76
E1487,54,72,87,65,99,377,76
E1203,99,100,49,43,86,377,76
E0886,59,96,78,52,91,376,76
E5248,63,85,93,48,87,376,76
E7535,70,95,55,98,58,376,76
E9424,43,91,69,94,79,376,76
E5129,98,61,46,76,95,376,76
E0063,56,84,78,63,95,376,76
E8372,61,50,80,88,97,376,76
E1723,94,55,71,76,80,376,76
E8307,47,68,84,100,77,376,76
E6097,71,91,47,95,72,376,76
E5686,63,84,85,54,90,376,76
E5798,95,57,82,94,48,376,76
E1278,97,59,85,63,72,376,76
E1936,47,71,75,88,95,376,76
E6299,60,73,97,78,68,376,76
E9859,58,63,80,84,91,376,76
E5726,82,64,70,88,72,376,76
E3347,81,41,89,85,80,376,76
E2318,96,47,62,96,75,376,76
E0019,68,41,97,88,82,376,76
E2526,79,56,94,71,76,376,76
E5428,82,99,76,76,43,376,76
E9453,60,90,59,67,100,376,76
E4599,42,93,87,87,67,376,76
E7022,71,81,78,59,87,376,76
E8198,94,55,72,75,80,376,76
E6498,41,64,80,92,99,376,76
E6425,44,67,92,77,96,376,76
E5961,46,67,79,100,84,376,76
E5349,90,70,77,93,46,376,76
E2262,51,88,74,92,71,376,76
E2355,43,100,92,94,47,376,76
E0701,48,87,84,79,78,376,76
E8799,74,57,80,95,70,376,76
E2382,88,54,63,77,94,376,76
E6907,71,76,74,79,76,376,76
E4675,44,54,95,87,96,376,76
E1532,74,79,86,96,41,376,76
E7271,93,95,82,53,53,376,76
E0705,88,89,76,65,58,376,76
E0745,95,80,40,74,87,376,76
E3341,74,88,97,40,77,376,76
E6264,43,67,81,99,85,375,75
E2185,50,79,71,95,80,375,75
E5850,88,41,71,98,77,375,75
E7165,68,72,99,88,48,375,75
E6958,100,98,55,51,71,375,75
E6304,59,56,98,74,88,375,75
E6769,77,53,70,91,84,375,75
E9947,73,90,60,57,95,375,75
E6568,90,62,89,54,80,375,75
E2729,85,65,98,53,74,375,75
E8805,67,67,87,92,62,375,75
E3183,58,98,66,97,56,375,75
E6433,77,67,66,95,70,375,75
E0660,67,47,91,96,74,375,75
E8336,90,61,51,98,75,375,75
E9991,96,86,42,77,74,375,75
E9885,72,91,46,68,98,375,75
E6135,79,59,94,62,81,375,75
E8427,70,79,70,66,90,375,75
E4860,100,96,57,73,49,375,75
E1295,92,92,56,44,91,375,75
E7962,78,61,92,50,94,375,75
E8655,90,91,93,59,42,375,75
E5236,99,64,44,82,86,375,75
E0452,90,71,85,74,55,375,75
E0481,60,58,93,69,95,375,75
E3015,49,68,78,87,93,375,75
E0559,79,50,77,91,78,375,75
E9406,78,64,75,78,80,375,75
E7145,78,70,96,86,45,375,75
E9791,49,88,74,64,100,375,75
E2416,73,62,85,62,93,375,75
E6112,66,77,97,51,84,375,75
E7852,63,85,55,100,72,375,75
E3382,61,97,80,57,80,375,75
E1997,95,56,94,88,42,375,75
E1399,83,82,63,75,72,375,75
E4033,63,89,75,69,79,375,75
E7888,70,82,62,66,95,375,75
E2601,40,76,86,95,78,375,75
E0483,71,57,85,82,80,375,75
E8402,94,91,90,48,52,375,75
E1878,95,59,88,67,66,375,75
E5342,51,68,98,79,79,375,75
E1681,87,98,60,49,81,375,75
E5992,84,97,56,93,45,375,75
E8776,62,73,93,88,59,375,75
E8939,100,92,85,46,52,375,75
E7781,52,97,78,98,50,375,75
E6982,63,53,66,94,98,374,75
E2752,54,98,97,40,85,374,75
E8474,88,64,100,51,71,374,75
E8459,100,80,73,74,47,374,75
E9734,42,93,65,80,94,374,75
E3540,61,89,69,61,94,374,75
E8746,69,78,91,84,52,374,75
E8186,100,56,67,81,70,374,75
E7326,48,67,97,100,62,374,75
E5427,99,50,68,84,73,374,75
E8132,71,57,97,91,58,374,75
E1519,45,77,94,62,96,374,75
E2310,94,89,65,55,71,374,75
E5954,51,75,88,80,80,374,75
E6738,95,65,50,90,74,374,75
E2509,50,76,74,84,90,374,75
E7769,95,59,55,68,97,374,75
E6574,71,63,89,96,55,374,75
E0011,56,60,94,96,68,374,75
E1683,87,64,44,87,92,374,75
E5607,66,56,72,92,88,374,75
E2272,83,55,90,95,51,374,75
E5751,72,56,66,91,89,374,75
E1936,85,90,60,95,44,374,75
E1840,60,64,83,82,85,374,75
E6581,95,42,71,69,97,374,75
E0367,82,47,71,74,100,374,75
E1649,48,52,79,96,99,374,75
E0527,63,89,81,79,62,374,75
E6311,48,50,78,98,100,374,75
E2565,70,76,88,98,42,374,75
E2126,63,57,89,85,80,374,75
E0299,90,45,83,89,67,374,75
E9834,96,99,88,47,44,374,75
E1201,77,80,92,41,84,374,75
E6193,51,100,86,58,79,374,75
E8546,47,87,84,56,100,374,75
E1744,98,69,40,93,74,374,75
E8174,93,67,78,65,71,374,75
E6291,95,62,93,48,76,374,75
E8428,65,84,94,77,54,374,75
E8278,42,92,83,78,79,374,75
E3834,90,81,44,59,100,374,75
E6787,94,62,77,100,41,374,75
E3489,54,71,52,97,100,374,75
E4800,45,78,86,71,94,374,75
E7400,97,68,68,75,66,374,75
E2253,79,87,69,83,56,374,75
E8239,92,55,59,82,86,374,75
E2251,94,99,45,84,51,373,75
E9528,54,81,53,95,90,373,75
E3821,76,43,80,92,82,373,75
E7378,61,66,61,90,95,373,75
E7470,87,60,67,93,66,373,75
E9514,97,65,54,59,98,373,75
E3784,47,82,79,71,94,373,75
E5606,63,49,94,74,93,373,75
E9345,54,78,99,67,75,373,75
E9349,79,98,64,70,62,373,75
E9538,58,91,73,74,77,373,75
E0531,86,59,93,59,76,373,75
E8012,71,93,91,42,76,373,75
E6536,41,87,94,93,58,373,75
E4958,65,78,59,77,94,373,75
E9791,93,42,91,71,76,373,75
E0010,64,85,84,59,81,373,75
E0862,60,66,87,84,76,373,75
E4362,62,55,98,61,97,373,75
E3603,61,86,45,100,81,373,75
E1825,79,73,52,88,81,373,75
E0839,58,79,67,85,84,373,75
E0952,49,93,88,97,46,373,75
E3669,51,76,49,98,99,373,75
E5410,60,95,68,98,52,373,75
E4607,75,100,74,74,50,373,75
E1600,86,58,65,64,100,373,75
E2369,98,51,57,74,93,373,75
E7342,74,83,57,77,82,373,75
E8010,57,95,95,53,73,373,75
E7526,63,63,89,83,75,373,75
E8141,59,71,94,54,95,373,75
E0545,48,84,92,94,55,373,75
E1988,78,66,77,93,59,373,75
E4463,83,89,88,56,57,373,75
E9342,92,72,59,62,88,373,75
E2664,85,84,84,49,71,373,75
E2204,45,84,91,92,61,373,75
E7932,74,76,59,80,83,372,75
E8640,49,61,94,76,92,372,75
E7026,62,85,72,78,75,372,75
E4494,86,57,86,67,76,372,75
E1163,76,92,59,87,58,372,75
E3273,43,93,83,88,65,372,75
E0888,80,77,79,93,43,372,75
E5145,87,63,53,70,99,372,75
E3510,83,65,46,98,80,372,75
E5112,65,40,89,92,86,372,75
E7939,82,78,97,68,47,372,75
E1144,89,60,62,84,77,372,75
E1876,93,54,54,89,82,372,75
E0503,80,73,60,91,68,372,75
E5262,63,78,91,55,85,372,75
E2266,88,47,83,100,54,372,75
E1026,96,57,78,73,68,372,75
E5493,81,46,76,96,73,372,75
E2659,79,41,76,93,83,372,75
E7466,69,90,87,71,55,372,75
E4916,94,91,58,88,41,372,75
E3675,88,75,85,77,47,372,75
E7629,58,76,68,83,87,372,75
E1285,79,87,71,77,58,372,75
E6369,61,85,75,53,98,372,75
E5627,79,59,94,59,81,372,75
E0197,74,69,69,92,68,372,75
E5445,98,61,79,61,73,372,75
E7213,68,95,80,47,82,372,75
E4457,76,94,47,58,97,372,75
E2895,74,55,91,70,82,372,75
E4884,58,91,70,55,98,372,75
E9655,64,86,53,71,98,372,75
E6580,80,73,85,76,58,372,75
E6224,61,96,75,84,56,372,75
E7795,74,91,84,48,75,372,75
E7658,91,64,45,100,72,372,75
E3514,76,44,80,79,93,372,75
E4831,61,93,88,49,81,372,75
E3367,93,69,81,42,87,372,75
E3458,97,88,43,97,47,372,75
E1371,68,63,87,96,58,372,75
E3904,71,83,67,90,61,372,75
E8811,86,60,92,40,93,371,75
E5276,66,65,63,84,93,371,75
E9197,94,69,80,67,61,371,75
E7660,64,65,97,55,90,371,75
E5180,42,96,89,100,44,371,75
E7178,84,74,93,68,52,371,75
E9653,71,93,91,67,49,371,75
E1731,78,69,43,91,90,371,75
E3768,51,100,70,85,65,371,75
E3667,95,87,70,74,45,371,75
E8073,82,79,60,66,84,371,75
E0692,64,86,96,43,82,371,75
E1147,83,76,86,49,77,371,75
E2675,98,48,100,49,76,371,75
E9372,83,82,80,41,85,371,75
E8429,77,92,62,89,51,371,75
E4243,88,74,69,70,70,371,75
E6719,84,46,70,75,96,371,75
E8967,89,80,94,50,58,371,75
E1760,60,65,76,80,90,371,75
E6761,97,49,65,66,94,371,75
E1388,61,92,90,61,67,371,75
E3692,67,44,80,95,85,371,75
E8896,90,73,88,57,63,371,75
E8051,49,80,47,97,98,371,75
E4889,96,53,73,81,68,371,75
E7571,97,50,42,85,97,371,75
E5001,91,51,79,62,88,371,75
E6496,70,54,97,54,96,371,75
E7988,73,73,79,88,58,371,75
E8326,86,54,64,82,85,371,75
E2147,97,100,47,63,64,371,75
E6946,92,81,51,83,64,371,75
E4888,92,48,67,79,85,371,75
E0488,42,82,73,96,78,371,75
E5769,51,65,92,95,67,370,74
E3520,48,100,81,71,70,370,74
E6219,50,81,99,70,70,370,74
E1798,75,95,91,48,61,370,74
E8465,63,59,70,92,86,370,74
E3099,84,77,59,55,95,370,74
E3311,91,67,47,78,87,370,74
E4649,73,93,69,53,82,370,74
E8444,89,69,69,71,72,370,74
E8725,60,82,93,69,66,370,74
E5734,90,70,66,62,82,370,74
E9594,56,87,89,46,92,370,74
E6455,79,94,47,97,53,370,74
E5180,75,92,61,43,99,370,74
E9771,51,96,83,52,88,370,74
E1776,66,98,84,67,55,370,74
E3842,81,76,72,88,53,370,74
E0251,64,60,94,87,65,370,74
E6302,88,93,69,41,79,370,74
E1152,90,40,90,80,70,370,74
E5901,96,52,53,92,77,370,74
E4377,87,89,77,67,50,370,74
E4568,59,70,100,57,84,370,74
E1161,97,75,43,58,97,370,74
E3749,62,87,65,80,76,370,74
E9239,82,73,84,84,47,370,74
E7407,92,61,77,46,94,370,74
E1376,49,83,62,79,97,370,74
E7919,42,91,54,86,97,370,74
E1347,86,69,69,75,71,370,74
E1312,97,76,96,55,46,370,74
E5089,55,80,64,77,94,370,74
E1815,63,93,69,57,88,370,74
E6220,64,94,50,79,83,370,74
E1818,77,97,53,91,52,370,74
E4596,65,83,67,57,98,370,74
E3532,78,54,44,97,97,370,74
E9379,88,91,82,45,64,370,74
E4389,80,83,60,91,56,370,74
E7366,65,49,100,78,78,370,74
E0648,73,45,83,69,100,370,74
E6165,52,98,65,93,62,370,74
E3452,58,54,98,93,67,370,74
E0423,76,41,85,88,80,370,74
E7512,89,41,84,76,80,370,74
E8670,42,75,83,93,77,370,74
E3517,84,63,59,70,94,370,74
E1066,94,61,68,98,49,370,74
E0588,62,70,49,98,91,370,74
E5737,69,65,82,87,67,370,74
E6958,56,88,60,75,91,370,74
E9665,70,96,78,50,76,370,74
E9974,95,58,77,86,54,370,74
E4571,82,59,75,63,90,369,74
E7093,67,92,43,99,68,369,74
E1524,79,99,51,49,91,369,74
E7182,73,63,71,99,63,369,74
E6903,69,85,77,40,98,369,74
E1523,86,77,68,82,56,369,74
E3953,52,89,49,94,85,369,74
E3521,78,84,50,58,99,369,74
E0821,54,98,76,93,48,369,74
E2973,66,89,83,87,44,369,74
E0687,44,59,79,98,89,369,74
E0037,76,77,59,78,79,369,74
E4763,79,81,59,79,71,369,74
E2973,48,88,51,92,90,369,74
E0738,54,87,71,85,72,369,74
E2449,57,92,95,78,47,369,74
E5676,69,46,99,81,74,369,74
E2324,61,89,87,64,68,369,74
E6802,98,72,57,80,62,369,74
E9608,72,50,95,77,75,369,74
E2944,91,100,50,47,81,369,74
E6258,87,63,91,81,47,369,74
E6011,77,51,95,59,87,369,74
E7307,54,86,96,43,90,369,74
E6589,77,69,93,53,77,369,74
E1702,72,41,84,91,81,369,74
E1323,93,43,48,91,94,369,74
E5732,54,79,53,93,90,369,74
E0837,54,100,80,51,84,369,74
E2848,69,81,57,78,84,369,74
E6341,76,69,54,87,83,369,74
E3567,47,100,57,73,92,369,74
E8121,77,60,91,81,60,369,74
E6526,51,58,93,96,70,368,74
E5186,100,52,60,91,65,368,74
E8185,91,50,53,89,85,368,74
E1775,78,71,43,94,82,368,74
E1341,70,79,98,55,66,368,74
E2490,92,45,75,89,67,368,74
E0134,86,91,42,77,72,368,74
E8597,73,89,57,88,61,368,74
E9551,91,65,84,56,72,368,74
E6992,95,61,84,65,63,368,74
E6733,78,100,53,63,74,368,74
E7141,61,58,90,89,70,368,74
E7162,53,99,97,50,69,368,74
E5207,63,72,85,86,62,368,74
E8636,72,97,58,41,100,368,74
E6548,46,87,96,92,47,368,74
E3813,76,73,85,63,71,368,74
E5062,51,89,69,93,66,368,74
E9507,63,60,55,91,99,368,74
E3013,47,92,89,58,82,368,74
E8935,57,68,88,97,58,368,74
E2642,40,80,88,65,95,368,74
E5395,49,68,70,95,86,368,74
E3473,96,42,46,95,89,368,74
E1059,59,87,92,48,82,368,74
E3039,49,86,71,65,97,368,74
E7550,69,54,87,91,67,368,74
E8467,49,81,99,68,71,368,74
E6619,60,59,84,87,78,368,74
E2786,58,95,72,73,70,368,74
E4767,72,86,84,57,69,368,74
E5976,98,51,50,100,69,368,74
E6402,61,89,84,63,71,368,74
E2545,45,98,70,56,99,368,74
E1443,82,99,69,59,59,368,74
E3603,96,97,58,71,46,368,74
E8025,94,73,64,40,97,368,74
E4969,77,58,97,57,79,368,74
E0446,97,46,80,83,62,368,74
E8853,60,90,62,63,93,368,74
E3570,78,47,91,74,77,367,74
E6099,58,62,99,58,90,367,74
E5514,41,96,89,46,95,367,74
E4256,76,76,50,78,87,367,74
E3754,56,61,87,100,63,367,74
E6472,93,62,89,77,46,367,74
E3032,58,54,94,73,88,367,74
E8001,92,67,67,69,72,367,74
E9198,78,76,74,95,44,367,74
E4459,40,91,53,88,95,367,74
E5131,52,79,100,43,93,367,74
E2735,44,91,46,98,88,367,74
E2943,83,67,50,78,89,367,74
E8485,85,51,91,97,43,367,74
E3100,95,80,63,72,57,367,74
E8079,76,48,96,80,67,367,74
E6122,87,96,74,43,67,367,74
E9250,83,48,67,72,97,367,74
E9205,79,41,97,90,60,367,74
E3911,91,58,47,92,79,367,74
E9848,95,42,89,66,75,367,74
E8793,84,89,89,57,48,367,74
E4330,56,75,95,78,63,367,74
E9817,52,65,93,76,81,367,74
E7130,85,77,70,49,86,367,74
E3320,95,91,52,66,63,367,74
E9471,75,64,66,79,83,367,74
E6529,44,91,70,75,87,367,74
E8631,82,69,79,65,72,367,74
E3897,91,74,40,93,69,367,74
E7711,92,40,77,88,70,367,74
E9621,79,69,78,95,46,367,74
E8471,98,100,43,60,66,367,74
E1353,85,91,63,82,46,367,74
E8888,82,55,74,65,91,367,74
E2919,63,65,66,81,92,367,74
E3577,81,83,41,81,81,367,74
E3926,95,79,58,71,64,367,74
E8915,82,91,56,80,58,367,74
E4236,100,53,82,54,78,367,74
E4371,79,74,82,71,61,367,74
E0574,56,50,89,83,89,367,74
E9100,80,71,74,67,75,367,74
E2747,74,84,55,80,74,367,74
E0994,93,51,70,98,55,367,74
E7646,88,85,65,45,84,367,74
E3026,91,40,85,98,53,367,74
E6180,92,90,53,88,43,366,74
E8495,64,85,88,88,41,366,74
E7817,67,64,65,89,81,366,74
E4415,73,92,61,48,92,366,74
E9944,64,92,98,60,52,366,74
E5105,75,79,61,69,82,366,74
E5919,44,76,59,89,98,366,74
E1236,88,64,57,92,65,366,74
E0717,79,84,86,68,49,366,74
E6838,52,69,89,83,73,366,74
E0430,46,80,85,73,82,366,74
E6579,78,89,53,93,53,366,74
E7225,68,91,96,58,53,366,74
E2852,65,86,84,40,91,366,74
E2043,53,78,66,86,83,366,74
E4795,70,76,90,72,58,366,74
E0531,85,90,79,56,56,366,74
E5078,92,98,44,55,77,366,74
E7728,95,86,58,78,49,366,74
E5329,40,58,90,83,95,366,74
E7033,71,90,84,72,49,366,74
E1898,59,51,86,75,95,366,74
E2010,58,47,97,89,75,366,74
E4727,83,88,85,40,70,366,74
E1848,79,65,41,86,95,366,74
E5839,50,51,87,81,97,366,74
E0272,72,82,68,57,87,366,74
E9216,74,69,76,96,51,366,74
E9355,63,92,57,56,98,366,74
E1220,91,73,99,43,60,366,74
E8137,89,43,53,87,94,366,74
E0484,81,81,75,46,83,366,74
E1357,81,59,58,70,98,366,74
E3972,74,69,90,45,88,366,74
E3543,64,72,70,74,86,366,74
E2146,83,59,41,87,96,366,74
E0260,88,96,51,62,69,366,74
E3236,54,85,68,66,93,366,74
E1942,64,65,90,75,72,366,74
E5975,66,43,89,94,74,366,74
E0479,84,68,58,57,98,365,73
E2935,96,65,73,50,81,365,73
E4923,84,83,66,55,77,365,73
E4933,75,53,70,87,80,365,73
E9486,97,90,84,50,44,365,73
E3544,96,67,47,99,56,365,73
E0422,55,80,62,79,89,365,73
E1647,77,45,81,100,62,365,73
E6648,45,88,48,95,89,365,73
E2770,66,92,75,89,43,365,73
E7315,87,68,93,71,46,365,73
E0768,84,79,47,63,92,365,73
E9418,77,59,52,93,84,365,73
E4829,92,96,56,47,74,365,73
E1022,54,96,73,68,74,365,73
E6004,93,99,71,50,52,365,73
E2449,85,85,42,73,80,365,73
E1043,57,64,84,80,80,365,73
E3741,83,54,64,90,74,365,73
E9139,69,51,86,99,60,365,73
E6552,73,82,52,98,60,365,73
E8518,92,84,54,59,76,365,73
E7893,63,62,48,95,97,365,73
E7569,78,71,76,71,69,365,73
E9223,91,65,95,73,41,365,73
E1163,100,87,82,48,48,365,73
E4978,95,67,95,60,48,365,73
E4488,54,99,53,95,64,365,73
E6053,95,86,98,46,40,365,73
E0340,94,67,82,66,56,365,73
E5280,86,71,70,60,78,365,73
E5928,78,81,79,81,46,365,73
E0810,86,78,69,44,88,365,73
E3426,97,79,61,59,69,365,73
E2978,56,54,95,76,84,365,73
E5835,89,93,90,53,40,365,73
E6992,52,95,92,68,58,365,73
E3957,79,75,73,72,66,365,73
E7162,53,74,61,98,79,365,73
E2505,95,92,64,52,62,365,73
E3633,86,94,81,54,50,365,73
E0206,99,66,75,41,84,365,73
E0282,63,78,77,47,100,365,73
E9851,62,61,97,84,61,365,73
E7792,42,81,99,84,59,365,73
E5442,99,54,48,69,95,365,73
E7767,92,87,83,46,57,365,73
E2505,41,97,57,84,86,365,73
E2163,83,87,76,63,56,365,73
E7502,61,83,81,76,64,365,73
E4936,86,89,56,48,85,364,73
E9410,45,91,64,99,65,364,73
E4770,92,91,53,57,71,364,73
E9065,97,40,90,78,59,364,73
E4424,78,47,88,59,92,364,73
E9198,55,82,75,92,60,364,73
E2118,100,70,47,68,79,364,73
E9337,82,79,87,75,41,364,73
E0175,62,76,93,54,79,364,73
E7902,71,86,51,94,62,364,73
E9535,44,97,95,41,87,364,73
E2359,77,59,97,87,44,364,73
E7576,70,63,90,68,73,364,73
E3487,68,73,60,84,79,364,73
E7571,88,71,47,90,68,364,73
E4605,59,88,89,47,81,364,73
E7858,64,68,96,84,52,364,73
E3633,91,61,92,77,43,364,73
E3633,51,64,78,72,99,364,73
E7756,54,98,78,46,88,364,73
E4687,54,98,49,100,63,364,73
E3097,79,75,82,44,84,364,73
E1095,77,60,41,88,98,364,73
E2342,98,89,63,58,56,364,73
E7745,66,75,57,89,77,364,73
E1277,73,61,88,42,100,364,73
E3173,43,91,71,63,96,364,73
E4854,75,97,46,50,96,364,73
E6586,64,65,41,95,99,364,73
E8179,67,94,44,86,73,364,73
E8188,57,74,99,91,43,364,73
E4623,76,76,58,62,92,364,73
E3272,42,51,97,78,96,364,73
E5838,87,91,65,69,52,364,73
E2087,74,78,89,74,49,364,73
E7181,87,74,88,46,69,364,73
E0679,45,78,71,97,73,364,73
E8840,55,56,84,73,96,364,73
E4604,64,79,82,77,62,364,73
E2690,42,79,75,93,75,364,73
E3093,89,69,48,99,59,364,73
E0714,99,51,45,87,82,364,73
E1559,83,77,55,88,60,363,73
E4638,78,53,76,88,68,363,73
E4288,83,89,66,63,62,363,73
E9762,86,85,65,42,85,363,73
E2701,69,61,78,78,77,363,73
E6274,69,94,74,63,63,363,73
E0606,94,59,92,77,41,363,73
E7942,68,80,89,59,67,363,73
E8436,43,51,97,94,78,363,73
E4686,55,88,78,49,93,363,73
E9236,66,75,85,70,67,363,73
E2808,75,67,63,79,79,363,73
E1809,95,47,59,74,88,363,73
E9277,93,84,62,46,78,363,73
E4143,69,54,94,97,49,363,73
E0836,60,65,54,97,87,363,73
E1483,65,86,63,53,96,363,73
E4472,93,45,41,98,86,363,73
E1771,57,92,81,58,75,363,73
E9819,55,96,44,86,82,363,73
E2880,97,71,74,58,63,363,73
E3105,59,85,72,77,70,363,73
E5093,51,87,82,47,96,363,73
E9982,100,64,71,76,52,363,73
E1637,56,73,71,80,83,363,73
E6146,45,95,61,65,97,363,73
E5699,64,73,51,78,97,363,73
E3598,68,73,79,60,83,363,73
E2637,84,66,74,71,68,363,73
E1947,51,81,95,68,68,363,73
E1360,72,52,85,86,68,363,73
E7939,77,59,53,95,79,363,73
E9850,71,69,70,94,59,363,73
E5905,96,89,67,49,62,363,73
E3868,62,72,94,53,82,363,73
E8377,47,98,45,97,76,363,73
E4429,61,78,72,96,56,363,73
E8806,82,65,97,63,56,363,73
E4454,54,98,69,91,51,363,73
E5112,67,48,92,94,62,363,73
E4482,84,82,75,69,53,363,73
E2300,90,69,66,84,54,363,73
E7421,56,93,98,50,66,363,73
E7172,81,58,61,77,86,363,73
E2751,91,86,75,61,49,362,73
E3705,92,85,42,65,78,362,73
E6869,64,60,82,83,73,362,73
E1607,75,88,58,51,90,362,73
E0485,52,93,82,56,79,362,73
E6308,68,67,86,48,93,362,73
E6273,77,86,69,52,78,362,73
E5512,91,77,64,46,84,362,73
E9068,98,46,71,94,53,362,73
E5378,97,49,81,86,49,362,73
E5392,53,89,100,52,68,362,73
E7140,63,65,85,70,79,362,73
E2782,46,54,96,94,72,362,73
E4168,75,86,64,77,60,362,73
E3931,93,41,68,85,75,362,73
E0038,54,91,66,52,99,362,73
E7319,78,91,85,58,50,362,73
E1399,98,60,80,70,54,362,73
E8006,60,74,72,87,69,362,73
E2360,100,43,79,44,96,362,73
E9402,90,55,89,53,75,362,73
E7347,41,79,94,68,80,362,73
E4959,75,69,57,84,77,362,73
E3269,43,57,92,95,75,362,73
E0594,67,96,87,61,51,362,73
E6747,80,44,95,67,76,362,73
E0766,93,58,56,73,82,362,73
E8988,63,85,66,49,99,362,73
E3621,72,89,57,63,81,362,73
E3933,83,85,68,82,44,362,73
E2279,76,93,43,88,62,362,73
E9378,75,56,70,85,76,362,73
E5066,79,100,77,60,46,362,73
E9688,71,76,85,71,59,362,73
E4460,51,73,76,97,65,362,73
E4178,62,91,66,93,50,362,73
E8019,97,76,42,81,66,362,73
E5905,48,79,88,70,77,362,73
E8639,94,83,77,54,54,362,73
E1484,79,78,83,82,40,362,73
E8599,100,91,87,40,44,362,73
E0293,93,77,60,73,59,362,73
E1441,47,75,89,90,60,361,73
E7348,79,61,68,78,75,361,73
E8252,65,64,52,80,100,361,73
E7202,70,83,78,59,71,361,73
E8793,99,96,66,55,45,361,73
E7848,90,76,82,53,60,361,73
E7173,91,74,56,68,72,361,73
E5584,66,91,72,86,46,361,73
E5727,80,83,55,74,69,361,73
E5986,67,62,50,94,88,361,73
E9822,97,51,58,98,57,361,73
E7009,57,72,84,60,88,361,73
E1331,40,64,91,88,78,361,73
E7595,40,80,84,77,80,361,73
E0692,81,40,84,97,59,361,73
E2217,85,62,75,89,50,361,73
E2651,98,57,74,72,60,361,73
E0656,64,50,90,63,94,361,73
E5982,51,71,90,77,72,361,73
E3180,50,62,87,97,65,361,73
E0343,52,95,56,80,78,361,73
E3804,89,70,51,56,95,361,73
E5806,64,68,92,80,57,361,73
E0957,80,61,99,72,49,361,73
E6773,51,82,74,69,85,361,73
E4045,74,73,69,77,68,361,73
E6641,79,70,92,76,44,361,73
E0657,78,74,81,59,69,361,73
E3376,96,62,91,58,54,361,73
E7963,49,97,91,84,40,361,73
E2584,40,98,83,87,53,361,73
E0256,89,80,49,45,98,361,73
E8424,94,65,88,72,42,361,73
E0672,98,78,52,61,72,361,73
E3568,64,98,47,81,71,361,73
E2220,43,62,73,95,88,361,73
E5801,95,80,78,61,46,360,72
E7039,73,51,58,89,89,360,72
E4891,49,98,88,72,53,360,72
E7850,65,62,98,87,48,360,72
E8459,54,95,49,76,86,360,72
E9877,81,82,53,82,62,360,72
E2249,77,60,80,43,100,360,72
E0091,85,82,71,51,71,360,72
E4399,100,82,61,57,60,360,72
E7593,93,89,46,80,52,360,72
E4064,44,40,98,97,81,360,72
E8192,64,94,81,69,52,360,72
E5832,58,93,63,47,99,360,72
E5841,64,99,81,47,69,360,72
E3298,97,81,84,45,53,360,72
E3670,67,100,49,61,83,360,72
E2732,62,82,96,60,60,360,72
E3745,93,63,80,61,63,360,72
E6842,84,70,85,73,48,360,72
E1159,89,44,83,78,66,360,72
E3809,48,61,96,68,87,360,72
E3602,80,86,61,53,80,360,72
E9620,65,97,94,57,47,360,72
E9746,56,78,76,87,63,360,72
E7763,87,49,51,77,96,360,72
E1338,100,49,68,60,83,360,72
E8843,86,83,92,50,49,360,72
E9005,58,75,55,87,85,360,72
E0534,46,91,79,74,70,360,72
E7772,93,99,52,44,72,360,72
E8102,83,51,51,81,94,360,72
E8540,51,69,77,81,82,360,72
E8879,50,63,74,100,73,360,72
E4599,83,49,87,56,85,360,72
E4514,50,91,86,91,42,360,72
E7497,75,53,90,86,56,360,72
E3061,43,86,94,57,80,360,72
E4544,86,63,77,54,80,360,72
E3857,89,87,83,61,40,360,72
E0179,100,65,93,40,61,359,72
E6725,79,88,52,73,67,359,72
E1673,44,76,85,73,81,359,72
E0520,54,87,81,63,74,359,72
E9719,84,58,65,53,99,359,72
E8183,74,40,86,91,68,359,72
E8774,88,88,41,61,81,359,72
E5251,80,76,45,98,60,359,72
E7081,62,42,90,98,67,359,72
E1456,87,85,74,62,51,359,72
E1480,46,89,63,65,96,359,72
E7151,46,81,98,64,70,359,72
E0280,93,52,76,90,48,359,72
E9110,95,75,49,89,51,359,72
E4092,56,98,60,98,47,359,72
E1415,81,91,82,65,40,359,72
E4139,55,43,94,74,93,359,72
E5918,61,79,61,93,65,359,72
E3497,80,71,88,50,70,359,72
E7244,83,100,53,68,55,359,72
E3618,60,72,66,65,96,359,72
E9007,89,64,41,83,82,359,72
E7494,72,88,74,66,59,359,72
E8487,79,92,55,81,52,359,72
E2985,43,72,76,80,88,359,72
E2384,55,79,89,55,81,359,72
E6942,82,51,58,70,98,359,72
E6898,92,54,64,85,64,359,72
E8129,87,77,63,62,70,359,72
E4388,49,100,63,47,100,359,72
E6693,52,90,97,74,46,359,72
E2194,98,73,49,95,44,359,72
E8918,94,48,40,94,83,359,72
E8889,43,57,89,93,77,359,72
E0698,53,100,90,54,62,359,72
E6197,43,57,95,72,92,359,72
E8041,56,45,82,88,88,359,72
E5976,94,83,54,45,83,359,72
E7614,66,54,86,59,94,359,72
E2249,81,92,60,68,58,359,72
E1938,92,44,64,100,58,358,72
E8676,77,40,92,50,99,358,72
E2725,79,64,45,90,80,358,72
E8738,93,41,72,92,60,358,72
E1025,83,69,80,68,58,358,72
E5309,96,88,47,51,76,358,72
E4564,72,58,90,60,78,358,72
E4090,61,87,58,84,68,358,72
E9890,43,77,77,63,98,358,72
E3532,57,66,85,68,82,358,72
E4052,53,78,44,96,87,358,72
E3694,67,96,41,65,89,358,72
E3305,48,89,95,70,56,358,72
E4039,41,75,97,88,57,358,72
E8846,40,98,78,100,42,358,72
E1440,70,40,68,90,90,358,72
E7668,53,79,81,64,81,358,72
E4593,98,83,53,50,74,358,72
E5527,82,63,76,96,41,358,72
E5541,93,62,70,41,92,358,72
E8091,89,97,75,41,56,358,72
E3624,81,44,60,74,99,358,72
E9182,70,69,100,41,78,358,72
E5924,88,77,87,58,48,358,72
E2147,92,73,65,55,73,358,72
E6228,69,52,89,59,89,358,72
E1952,89,45,75,63,86,358,72
E1326,95,93,49,40,81,358,72
E8569,77,94,61,68,58,358,72
E9506,77,59,81,84,57,358,72
E8412,90,53,88,63,64,358,72
E0438,95,45,92,86,40,358,72
E2523,80,51,49,84,94,358,72
E7828,80,64,71,53,90,358,72
E5664,81,71,99,51,56,358,72
E8501,49,83,95,76,55,358,72
E1518,53,82,95,66,62,358,72
E9325,80,71,57,91,59,358,72
E6878,42,79,96,97,44,358,72
E1447,75,68,66,58,91,358,72
E9126,73,83,49,85,68,358,72
E6473,52,87,67,52,100,358,72
E5807,70,51,69,72,96,358,72
E7640,85,79,45,92,57,358,72
E9726,88,48,69,92,61,358,72
E3292,78,91,53,43,92,357,72
E0194,63,91,43,72,88,357,72
E9522,61,70,70,61,95,357,72
E6967,83,78,52,79,65,357,72
E6972,87,60,77,40,93,357,72
E7968,88,66,73,56,74,357,72
E2226,59,66,72,67,93,357,72
E6072,41,94,56,83,83,357,72
E8664,75,73,66,93,50,357,72
E4394,83,62,40,72,100,357,72
E4884,86,41,83,52,95,357,72
E4259,68,48,72,97,72,357,72
E1807,60,88,66,73,70,357,72
E0231,65,48,96,73,75,357,72
E2488,93,78,50,83,53,357,72
E0110,87,75,47,65,83,357,72
E5391,42,88,87,94,46,357,72
E1270,87,46,88,60,76,357,72
E5781,61,94,45,66,91,357,72
E3256,72,70,51,88,76,357,72
E9411,50,65,100,94,48,357,72
E7634,73,61,64,75,84,357,72
E7205,65,69,66,75,82,357,72
E4669,98,50,85,82,42,357,72
E2035,76,76,61,54,90,357,72
E7740,87,67,64,93,46,357,72
E5691,43,96,84,59,75,357,72
E0604,89,52,85,47,84,357,72
E9042,78,40,67,99,73,357,72
E1512,54,82,85,45,91,357,72
E8953,63,77,61,63,93,357,72
E6377,82,52,64,99,60,357,72
E7265,47,85,80,100,45,357,72
E9925,85,79,54,60,79,357,72
E4656,71,77,94,46,69,357,72
E0241,96,72,42,87,60,357,72
E3004,94,66,69,71,57,357,72
E7768,96,79,43,62,77,357,72
E4035,56,83,65,67,86,357,72
E3507,72,99,49,49,88,357,72
E4944,78,77,80,78,44,357,72
E0145,84,77,78,77,41,357,72
E5753,42,81,93,82,59,357,72
E1472,63,78,79,53,84,357,72
E3310,86,55,84,43,89,357,72
E5275,93,71,83,43,67,357,72
E6936,44,69,77,83,84,357,72
E3803,92,83,53,51,77,356,72
E5027,61,61,84,70,80,356,72
E2154,48,96,79,68,65,356,72
E1613,100,52,51,97,56,356,72
E0972,93,58,63,48,94,356,72
E5430,70,89,58,46,93,356,72
E7870,83,57,92,46,78,356,72
E8388,78,68,67,83,60,356,72
E3132,85,57,90,60,64,356,72
E6722,56,70,89,67,74,356,72
E5671,45,63,60,93,95,356,72
E5387,52,83,92,82,47,356,72
E0928,46,97,99,74,40,356,72
E5818,98,74,40,56,88,356,72
E2728,93,44,76,100,43,356,72
E0672,68,67,56,84,81,356,72
E1994,79,77,40,79,81,356,72
E9894,84,77,100,54,41,356,72
E8777,57,57,59,96,87,356,72
E9197,67,90,78,64,57,356,72
E9911,71,76,77,89,43,356,72
E2182,87,93,82,40,54,356,72
E8837,53,66,82,58,97,356,72
E3825,48,85,98,42,83,356,72
E6505,84,97,72,63,40,356,72
E0841,100,49,89,69,49,356,72
E6215,62,50,80,84,80,356,72
E1453,93,64,51,73,75,356,72
E6184,87,53,86,84,46,356,72
E6473,67,68,68,54,99,356,72
E3042,79,81,80,76,40,356,72
E9868,87,63,42,75,89,356,72
E2036,57,80,50,73,96,356,72
E2423,81,93,45,77,60,356,72
E8434,87,86,47,75,61,356,72
E4084,43,74,68,76,95,356,72
E5732,95,59,61,86,55,356,72
E9827,76,82,83,66,49,356,72
E6969,83,43,74,97,59,356,72
E8353,68,54,55,93,86,356,72
E1330,95,76,57,73,55,356,72
E7778,52,78,97,41,88,356,72
E4569,60,60,70,78,88,356,72
E3450,52,53,98,69,84,356,72
E7112,92,62,75,59,68,356,72
E7396,58,80,91,53,74,356,72
E7157,88,65,64,51,88,356,72
E3356,90,61,53,83,69,356,72
E7361,49,96,86,58,67,356,72
E6977,70,97,60,82,47,356,72
E9249,90,79,92,46,49,356,72
E0898,70,81,91,61,53,356,72
E6903,88,74,57,80,57,356,72
E0818,82,97,54,79,44,356,72
E3504,53,98,73,51,80,355,71
E8669,65,81,86,46,77,355,71
E3212,89,56,42,86,82,355,71
E2045,73,84,50,53,95,355,71
E3780,65,86,80,70,54,355,71
E1582,63,47,97,68,80,355,71
E7676,52,79,80,67,77,355,71
E1624,77,41,92,54,91,355,71
E4058,67,99,50,97,42,355,71
E6442,69,68,88,51,79,355,71
E1236,97,77,42,86,53,355,71
E2745,88,69,79,79,40,355,71
E8941,61,74,47,85,88,355,71
E1018,83,41,100,89,42,355,71
E4005,99,69,70,50,67,355,71
E3223,56,60,87,85,67,355,71
E3631,89,50,83,43,90,355,71
E1514,99,94,58,64,40,355,71
E8048,40,85,90,84,56,355,71
E6403,94,58,64,92,47,355,71
E9499,86,94,55,80,40,355,71
E6948,63,75,85,45,87,355,71
E3090,44,83,85,74,69,355,71
E9397,90,42,40,100,83,355,71
E0233,58,43,77,93,84,355,71
E2266,97,47,70,70,71,355,71
E2769,54,81,58,94,68,355,71
E5081,76,61,77,55,86,355,71
E6446,86,68,72,81,48,355,71
E1078,69,59,77,69,81,355,71
E3192,65,54,83,72,81,355,71
E9718,75,74,89,46,71,355,71
E1546,48,55,67,94,91,355,71
E7887,73,51,100,72,59,355,71
E5493,50,49,96,62,98,355,71
E9637,40,87,71,59,98,355,71
E0340,79,47,63,98,68,355,71
E6591,48,44,84,96,83,355,71
E3277,99,40,69,50,97,355,71
E5031,83,64,58,59,91,355,71
E5797,86,43,93,42,91,355,71
E4210,98,76,41,92,48,355,71
E4884,91,81,46,45,92,355,71
E0305,48,83,91,91,42,355,71
E8587,45,96,70,54,90,355,71
E8005,82,94,40,83,56,355,71
E2981,88,62,68,44,93,355,71
E1035,42,58,80,99,76,355,71
E8126,43,86,77,96,53,355,71
E9684,93,67,63,74,58,355,71
E6977,53,86,95,72,48,354,71
E5321,77,60,63,86,68,354,71
E3121,74,59,80,64,77,354,71
E2124,98,51,74,66,65,354,71
E4231,60,45,95,58,96,354,71
E3129,73,77,88,76,40,354,71
E4223,57,81,81,50,85,354,71
E8535,57,79,52,67,99,354,71
E6484,65,85,90,65,49,354,71
E6471,61,50,79,69,95,354,71
E4374,89,67,94,45,59,354,71
E5912,64,94,48,87,61,354,71
E4336,80,72,76,69,57,354,71
E9835,80,62,49,66,97,354,71
E1925,71,64,91,86,42,354,71
E9226,77,62,87,66,62,354,71
E3440,64,73,80,77,60,354,71
E1195,75,60,99,56,64,354,71
E8252,46,90,44,95,79,354,71
E3242,91,45,55,69,94,354,71
E4580,68,98,66,45,77,354,71
E7551,47,69,84,76,78,354,71
E8928,73,89,47,77,68,354,71
E1187,97,94,71,52,40,354,71
E8411,96,64,89,65,40,354,71
E1475,85,60,90,61,58,354,71
E8891,100,56,97,43,58,354,71
E5116,59,64,83,81,67,354,71
E0791,87,50,95,55,67,354,71
E9703,92,55,73,49,85,354,71
E2700,66,45,54,94,95,354,71
E0811,100,72,57,82,43,354,71
E8054,49,41,100,79,85,354,71
E3466,79,52,69,65,89,354,71
E4760,61,87,57,57,92,354,71
E5697,63,75,73,45,98,354,71
E9796,100,64,55,48,87,354,71
E9572,86,64,80,40,84,354,71
E9166,52,70,48,90,94,354,71
E6059,44,98,94,63,54,353,71
E8574,81,49,65,67,91,353,71
E0610,47,74,93,90,49,353,71
E7760,92,76,84,59,42,353,71
E8214,94,70,44,50,95,353,71
E4720,51,86,82,85,49,353,71
E7461,75,56,87,56,79,353,71
E6396,92,77,72,44,68,353,71
E1537,64,95,40,80,74,353,71
E7046,52,96,50,60,95,353,71
E6564,41,83,85,79,65,353,71
E4124,61,96,79,40,77,353,71
E1749,76,59,43,90,85,353,71
E7847,63,93,60,45,92,353,71
E5087,86,48,84,77,58,353,71
E8741,67,88,44,72,82,353,71
E4234,59,81,95,61,57,353,71
E6734,88,59,78,62,66,353,71
E4522,45,91,58,78,81,353,71
E4051,49,41,87,92,84,353,71
E0799,47,73,90,61,82,353,71
E4468,78,78,67,54,76,353,71
E6432,49,81,78,93,52,353,71
E0391,96,64,52,86,55,353,71
E8307,83,49,71,52,98,353,71
E7420,54,69,68,93,69,353,71
E2978,52,63,96,42,100,353,71
E3090,50,71,82,58,92,353,71
E4795,64,58,54,91,86,353,71
E3586,95,44,87,86,41,353,71
E8507,52,73,85,65,78,353,71
E7009,90,62,48,68,85,353,71
E5729,65,89,91,45,63,353,71
E5070,89,54,99,67,44,353,71
E9269,69,96,78,53,57,353,71
E5930,76,72,68,49,88,353,71
E1637,96,76,49,40,92,353,71
E3045,61,99,95,55,43,353,71
E8968,83,42,95,89,44,353,71
E6051,47,98,71,89,48,353,71
E9293,64,77,72,42,98,353,71
E8053,81,77,48,85,61,352,71
E2657,44,55,93,100,60,352,71
E5375,63,91,73,50,75,352,71
E5506,65,82,86,50,69,352,71
E9780,47,86,49,75,95,352,71
E2069,83,99,45,74,51,352,71
E3882,69,50,59,77,97,352,71
E6797,67,67,62,68,88,352,71
E9341,50,74,47,90,91,352,71
E1567,62,78,69,83,60,352,71
E6170,96,54,57,89,56,352,71
E2847,84,75,62,79,52,352,71
E2347,64,75,88,71,54,352,71
E4781,66,95,53,60,78,352,71
E8676,81,93,71,41,66,352,71
E7619,50,68,84,75,75,352,71
E0166,95,43,64,68,82,352,71
E5818,68,64,71,69,80,352,71
E6043,54,44,73,87,94,352,71
E5261,55,66,81,58,92,352,71
E2829,59,66,65,91,71,352,71
E9381,78,59,47,99,69,352,71
E6623,56,48,90,68,90,352,71
E4866,43,62,74,86,87,352,71
E6108,95,54,59,98,46,352,71
E7813,57,62,72,73,88,352,71
E9933,58,55,97,78,64,352,71
E3387,81,76,71,80,44,352,71
E1737,89,62,82,63,56,352,71
E6030,83,63,55,83,68,352,71
E2863,60,67,85,90,50,352,71
E1435,65,62,82,88,55,352,71
E7573,86,41,88,70,67,352,71
E1658,65,76,56,69,86,352,71
E3063,90,47,95,45,75,352,71
E4226,64,70,62,89,67,352,71
E4473,86,96,67,45,58,352,71
E1492,84,73,49,76,70,352,71
E4481,71,57,92,53,79,352,71
E7981,62,95,42,87,66,352,71
E9524,43,43,92,99,75,352,71
E9834,87,91,74,57,43,352,71
E2955,99,73,75,49,56,352,71
E7297,57,54,87,89,64,351,71
E2676,75,65,74,81,56,351,71
E1193,69,90,46,78,68,351,71
E8505,67,56,90,58,80,351,71
E1508,69,68,97,65,52,351,71
E0692,62,51,81,64,93,351,71
E4118,47,58,90,81,75,351,71
E4225,76,86,71,42,76,351,71
E2055,41,97,61,70,82,351,71
E4076,47,74,79,81,70,351,71
E6087,98,71,51,59,72,351,71
E4726,41,91,50,87,82,351,71
E5284,56,57,45,100,93,351,71
E8760,55,68,96,68,64,351,71
E9080,43,77,67,86,78,351,71
E1986,89,69,74,52,67,351,71
E1350,68,41,99,64,79,351,71
E1888,65,94,67,78,47,351,71
E9531,42,84,59,90,76,351,71
E5005,95,50,61,82,63,351,71
E9279,94,42,74,88,53,351,71
E5954,55,59,55,92,90,351,71
E9594,90,43,100,40,78,351,71
E7846,61,51,99,93,47,351,71
E4076,56,69,78,74,74,351,71
E2635,64,89,41,88,69,351,71
E6088,74,56,42,82,97,351,71
E1720,85,56,81,78,51,351,71
E6930,58,91,52,68,82,351,71
E8544,72,88,75,43,73,351,71
E9799,75,96,87,48,45,351,71
E0556,46,81,67,99,58,351,71
E9752,47,87,95,66,56,351,71
E9762,67,55,73,72,84,351,71
E6315,89,47,54,75,86,351,71
E1508,99,66,57,80,49,351,71
E1446,97,44,80,68,62,351,71
E0204,59,82,79,58,73,351,71
E3480,79,59,86,41,86,351,71
E3579,57,83,59,64,87,350,70
E4733,68,66,95,72,49,350,70
E5493,61,84,77,70,58,350,70
E7315,55,41,86,72,96,350,70
E1782,97,63,92,57,41,350,70
E3628,66,71,97,42,74,350,70
E0451,59,89,48,81,73,350,70
E8996,74,93,42,65,76,350,70
E4213,51,92,93,54,60,350,70
E7019,54,100,87,44,65,350,70
E5292,84,58,48,78,82,350,70
E1572,65,98,42,88,57,350,70
E5585,88,68,51,87,56,350,70
E4717,89,48,96,68,49,350,70
E5719,87,48,79,86,50,350,70
E5294,91,53,74,75,57,350,70
E4745,60,57,56,83,94,350,70
E8390,57,67,63,76,87,350,70
E3260,63,73,44,78,92,350,70
E0320,84,71,87,45,63,350,70
E1070,41,82,57,74,96,350,70
E2746,68,79,97,60,46,350,70
E4748,57,81,47,91,74,350,70
E1783,88,64,55,87,56,350,70
E1116,70,75,52,55,98,350,70
E0168,88,79,71,61,51,350,70
E3359,97,64,67,59,63,350,70
E9324,75,41,88,82,64,350,70
E6123,80,74,65,76,55,350,70
E1250,66,61,96,75,52,350,70
E1809,58,76,65,55,96,350,70
E0869,49,93,91,42,75,350,70
E8149,71,76,48,63,92,350,70
E8733,47,68,53,89,93,350,70
E7797,57,48,92,71,82,350,70
E3040,69,50,73,69,89,350,70
E1344,59,89,89,43,70,350,70
E4810,40,62,49,100,99,350,70
E6830,49,68,100,64,69,350,70
E2911,68,50,72,80,80,350,70
E4461,48,78,91,61,72,350,70
E2916,75,48,70,66,91,350,70
E6040,64,78,80,48,80,350,70
E5332,69,73,94,65,49,350,70
E4656,57,89,62,53,89,350,70
E5540,99,42,58,99,52,350,70
E7810,99,42,80,83,46,350,70
E0060,94,75,58,72,51,350,70
E7051,72,66,97,73,42,350,70
E5267,86,58,80,81,45,350,70
E0842,80,45,75,92,58,350,70
E6140,75,51,93,55,76,350,70
E2905,69,55,50,86,90,350,70
E3683,55,50,84,68,93,350,70
E2695,58,93,56,93,50,350,70
E7679,40,88,74,57,91,350,70
E2270,72,75,43,64,95,349,70
E2448,70,69,64,74,72,349,70
E6991,76,60,81,59,73,349,70
E9131,56,90,72,87,44,349,70
E1295,56,89,67,88,49,349,70
E2003,64,79,44,62,100,349,70
E4658,88,80,44,97,40,349,70
E6344,68,93,56,83,49,349,70
E2390,96,48,82,43,80,349,70
E0194,77,80,46,50,96,349,70
E8867,78,72,65,56,78,349,70
E8071,94,60,85,68,42,349,70
E8370,53,53,77,68,98,349,70
E8567,90,41,60,100,58,349,70
E8244,81,47,43,82,96,349,70
E4286,78,52,88,63,68,349,70
E0476,76,51,69,95,58,349,70
E0470,87,83,54,56,69,349,70
E9270,49,82,72,91,55,349,70
E2549,83,62,65,75,64,349,70
E3179,51,69,47,84,98,349,70
E1005,52,85,86,57,69,349,70
E8913,85,74,93,57,40,349,70
E8264,62,46,98,87,56,349,70
E2495,84,95,52,78,40,349,70
E1635,61,84,59,72,73,349,70
E1165,67,83,59,96,44,349,70
E1479,67,40,81,62,99,349,70
E3828,45,86,93,58,67,349,70
E7756,98,41,86,77,47,349,70
E2541,79,44,98,60,68,349,70
E9095,65,79,72,76,57,349,70
E0783,67,78,100,59,45,349,70
E8537,67,63,76,76,67,349,70
E8833,48,99,93,69,40,349,70
E2733,95,71,54,61,68,349,70
E6765,68,95,70,45,71,349,70
E7297,89,79,41,96,44,349,70
E2346,41,55,88,88,77,349,70
E7651,76,47,75,96,55,349,70
E3031,87,59,50,57,96,349,70
E9073,42,85,93,71,58,349,70
E1859,55,77,76,63,78,349,70
E3079,71,79,85,69,45,349,70
E8885,40,73,57,83,96,349,70
E4068,81,49,59,74,86,349,70
E5868,46,75,97,71,60,349,70
E4333,55,77,82,95,40,349,70
E8921,84,94,76,50,45,349,70
E6339,96,43,50,65,95,349,70
E8252,51,48,95,65,90,349,70
E8572,96,59,57,88,49,349,70
E5468,52,82,88,85,41,348,70
E6415,72,100,56,72,48,348,70
E0726,85,62,58,98,45,348,70
E7347,42,63,83,93,67,348,70
E9390,66,41,93,100,48,348,70
E2247,85,72,85,61,45,348,70
E5950,43,62,91,59,93,348,70
E0127,81,79,47,84,57,348,70
E8947,43,87,75,68,75,348,70
E8555,95,61,48,64,80,348,70
E1474,66,93,51,75,63,348,70
E5943,85,94,71,42,56,348,70
E7783,45,71,82,60,90,348,70
E3031,95,78,63,69,43,348,70
E2688,85,68,77,56,62,348,70
E7343,52,46,96,78,76,348,70
E4229,68,63,63,72,82,348,70
E2674,97,61,77,64,49,348,70
E2500,62,88,70,65,63,348,70
E8738,68,98,45,48,89,348,70
E5873,43,81,71,69,84,348,70
E8281,64,80,61,76,67,348,70
E4172,49,92,71,82,54,348,70
E0398,66,72,76,62,72,348,70
E2276,71,58,65,66,88,348,70
E8699,91,96,50,57,54,348,70
E5752,82,59,72,76,59,348,70
E3246,95,71,56,63,63,348,70
E7376,81,63,60,81,63,348,70
E0571,73,81,86,67,41,348,70
E4856,92,74,63,50,69,348,70
E6398,40,72,95,54,87,348,70
E7638,69,49,79,51,100,348,70
E1471,55,59,82,73,79,348,70
E0231,73,72,54,51,98,348,70
E6649,60,94,58,79,57,348,70
E1847,97,62,48,72,69,348,70
E6657,77,90,48,54,79,348,70
E1212,50,60,88,86,64,348,70
E9934,88,58,56,56,90,348,70
E2341,60,74,95,68,51,348,70
E2121,60,78,55,66,89,348,70
E5838,45,72,51,87,93,348,70
E0852,55,87,65,53,88,348,70
E4623,91,79,77,59,42,348,70
E1673,84,46,91,80,47,348,70
E3512,71,73,45,92,66,347,70
E0564,86,40,94,44,83,347,70
E0140,76,82,75,72,42,347,70
E5800,74,57,71,85,60,347,70
E1385,56,97,54,58,82,347,70
E9496,58,92,44,94,59,347,70
E7836,55,67,86,69,70,347,70
E5292,89,75,91,45,47,347,70
E7913,87,55,94,61,50,347,70
E1370,100,48,65,66,68,347,70
E9536,54,97,66,53,77,347,70
E2290,55,64,94,81,53,347,70
E6613,72,79,76,50,70,347,70
E9944,77,75,46,56,93,347,70
E7768,80,45,70,88,64,347,70
E2686,95,50,97,54,51,347,70
E0694,45,76,93,66,67,347,70
E3399,55,63,82,61,86,347,70
E5742,65,55,60,83,84,347,70
E0509,96,85,43,73,50,347,70
E5265,92,92,46,74,43,347,70
E0736,88,95,60,57,47,347,70
E9370,65,97,53,68,64,347,70
E2263,45,49,99,77,77,347,70
E4638,40,82,79,82,64,347,70
E8064,73,71,58,51,94,347,70
E5324,49,86,70,83,59,347,70
E8988,89,43,68,82,65,347,70
E0546,86,65,70,60,66,347,70
E2716,49,42,93,65,98,347,70
E2733,69,96,84,55,43,347,70
E9269,53,44,84,78,88,347,70
E9477,40,53,76,87,91,347,70
E9766,72,87,87,58,43,347,70
E1109,51,88,80,46,82,347,70
E2831,83,76,87,59,42,347,70
E9867,83,83,65,75,41,347,70
E1339,77,62,69,77,62,347,70
E6393,99,41,45,73,89,347,70
E2729,93,54,72,82,46,347,70
E6707,94,57,59,50,87,347,70
E9938,53,59,56,79,100,347,70
E6954,81,91,48,61,66,347,70
E7073,80,71,97,55,44,347,70
E5737,73,97,40,42,95,347,70
E7289,52,84,40,82,89,347,70
E8960,63,79,45,85,75,347,70
E8293,81,87,80,48,51,347,70
E9953,82,51,48,81,84,346,70
E0395,44,98,53,57,94,346,70
E5264,71,68,79,45,83,346,70
E2097,89,60,58,77,62,346,70
E1461,82,44,91,82,47,346,70
E3942,68,56,100,56,66,346,70
E2715,63,96,85,59,43,346,70
E5453,71,66,79,87,43,346,70
E6881,94,41,78,65,68,346,70
E9971,42,88,73,66,77,346,70
E8833,48,80,95,47,76,346,70
E2169,71,65,59,74,77,346,70
E6785,52,82,92,52,68,346,70
E0798,71,68,98,41,68,346,70
E6430,46,86,56,80,78,346,70
E4056,45,93,47,92,69,346,70
E8725,40,44,100,99,63,346,70
E9120,45,92,61,82,66,346,70
E4642,59,58,90,69,70,346,70
E9057,87,60,43,57,99,346,70
E2173,55,72,44,83,92,346,70
E6542,68,68,40,93,77,346,70
E8912,67,81,62,60,76,346,70
E3798,58,82,70,80,56,346,70
E8650,53,54,99,70,70,346,70
E7774,64,74,76,54,78,346,70
E5678,62,49,89,64,82,346,70
E0929,52,66,90,69,69,346,70
E3898,74,73,70,67,62,346,70
E5576,68,51,70,70,87,346,70
E8543,53,81,64,62,86,346,70
E0285,72,43,66,81,84,346,70
E7365,60,85,53,94,54,346,70
E8175,88,67,54,64,73,346,70
E1999,58,81,49,95,63,346,70
E1280,95,45,58,67,80,345,69
E7422,89,57,92,65,42,345,69
E6009,59,55,97,83,51,345,69
E5930,80,46,90,86,43,345,69
E0736,56,82,77,67,63,345,69
E8529,57,50,90,100,48,345,69
E4086,70,91,73,71,40,345,69
E1654,73,50,61,63,98,345,69
E6958,50,90,43,75,87,345,69
E7410,71,74,63,43,94,345,69
E3153,82,52,67,93,51,345,69
E7169,59,82,56,97,51,345,69
E3880,100,55,48,84,58,345,69
E6187,97,43,87,69,49,345,69
E0090,73,51,68,89,64,345,69
E9065,69,48,59,80,89,345,69
E9900,80,59,64,44,98,345,69
E6877,53,95,59,83,55,345,69
E5932,67,95,52,54,77,345,69
E2615,99,50,51,83,62,345,69
E2536,71,60,98,69,47,345,69
E1947,44,82,97,61,61,345,69
E9507,92,44,64,64,81,345,69
E7228,73,88,57,67,60,345,69
E1996,63,85,49,65,83,345,69
E5353,84,49,49,88,75,345,69
E5871,65,72,99,60,49,345,69
E3301,52,73,43,97,80,345,69
E2217,56,69,91,86,43,345,69
E7877,59,53,96,41,96,345,69
E7418,94,84,41,86,40,345,69
E1813,52,87,79,63,64,345,69
E2938,95,67,42,66,75,345,69
E9204,86,94,75,48,42,345,69
E2361,66,84,48,95,52,345,69
E6024,73,63,58,67,84,345,69
E7642,77,54,73,43,98,345,69
E2560,42,77,87,96,43,345,69
E3933,42,56,72,89,86,345,69
E4066,63,56,87,56,83,345,69
E1131,79,51,67,85,62,344,69
E2358,56,97,58,83,50,344,69
E4220,86,41,88,48,81,344,69
E0404,86,43,77,87,51,344,69
E8676,60,64,62,84,74,344,69
E7868,61,72,99,70,42,344,69
E1774,58,59,83,92,52,344,69
E2931,86,51,64,73,70,344,69
E2358,70,45,66,87,76,344,69
E0409,89,70,53,73,59,344,69
E6487,86,60,58,96,44,344,69
E1405,84,68,62,89,41,344,69
E2082,46,43,74,100,81,344,69
E7770,46,83,99,52,64,344,69
E2959,44,47,78,75,100,344,69
E1720,52,84,69,44,95,344,69
E0115,63,55,100,71,55,344,69
E0784,66,43,63,93,79,344,69
E7488,49,89,61,76,69,344,69
E0325,61,59,58,86,80,344,69
E7566,48,82,91,79,44,344,69
E2135,70,55,70,93,56,344,69
E1405,44,70,80,95,55,344,69
E2423,57,51,98,72,66,344,69
E3858,98,63,57,53,73,344,69
E1401,66,91,48,40,99,344,69
E2244,97,57,67,46,77,344,69
E3229,47,49,86,67,95,344,69
E9159,54,56,100,51,83,344,69
E2038,43,80,54,99,68,344,69
E5249,40,54,61,89,100,344,69
E3203,74,88,87,41,54,344,69
E2560,40,60,90,94,60,344,69
E8395,47,73,65,87,72,344,69
E6698,67,72,80,68,57,344,69
E4614,80,67,79,53,65,344,69
E2502,42,59,74,83,86,344,69
E5136,55,87,82,77,43,344,69
E7676,75,85,74,69,41,344,69
E4847,84,85,58,76,41,344,69
E7802,70,46,92,96,40,344,69
E2521,63,62,97,68,54,344,69
E1745,90,55,44,64,91,344,69
E1056,71,66,67,83,57,344,69
E8396,97,63,89,53,42,344,69
E5024,68,49,96,91,40,344,69
E4760,43,81,57,74,89,344,69
E7811,41,67,72,98,66,344,69
E3864,83,71,90,47,53,344,69
E6121,96,87,42,53,66,344,69
E4441,93,40,85,56,70,344,69
E6051,55,98,62,56,73,344,69
E0446,42,83,53,84,82,344,69
E1067,75,52,52,69,95,343,69
E6959,87,82,60,41,73,343,69
E1055,64,88,78,71,42,343,69
E1485,97,67,48,61,70,343,69
E6171,73,74,56,51,89,343,69
E7392,66,58,82,85,52,343,69
E3308,90,79,43,49,82,343,69
E7311,48,64,94,76,61,343,69
E1775,83,73,75,55,57,343,69
E0191,85,53,88,43,74,343,69
E2864,68,71,65,60,79,343,69
E9725,64,94,67,50,68,343,69
E6854,73,99,75,48,48,343,69
E6809,95,81,81,41,45,343,69
E3237,52,99,66,86,40,343,69
E2141,89,98,56,43,57,343,69
E0532,98,90,71,41,43,343,69
E0402,62,54,58,74,95,343,69
E6539,47,100,62,46,88,343,69
E8649,73,47,76,86,61,343,69
E0032,99,43,62,70,69,343,69
E1936,47,97,77,59,63,343,69
E6574,56,42,85,92,68,343,69
E0862,50,86,64,50,93,343,69
E7225,78,43,58,72,92,343,69
E9140,62,94,71,64,52,343,69
E1440,91,83,41,69,59,343,69
E1054,84,60,43,56,100,343,69
E3493,55,72,70,61,85,343,69
E5468,97,93,42,40,71,343,69
E7466,86,78,56,57,66,343,69
E3036,74,90,54,64,61,343,69
E3108,69,65,86,47,76,343,69
E5811,53,86,62,88,54,343,69
E7646,89,69,79,43,63,343,69
E9289,84,45,67,100,47,343,69
E1872,56,66,74,92,55,343,69
E7272,80,80,43,99,41,343,69
E7401,91,75,72,58,47,343,69
E1593,94,55,77,67,50,343,69
E2496,58,71,81,56,77,343,69
E4956,49,58,77,89,69,342,69
E1261,49,96,42,85,70,342,69
E8697,48,79,95,76,44,342,69
E2992,44,69,49,93,87,342,69
E1046,71,95,66,53,57,342,69
E3094,85,65,41,79,72,342,69
E9063,99,79,42,66,56,342,69
E6852,58,82,72,72,58,342,69
E7618,90,61,53,80,58,342,69
E6845,45,90,55,69,83,342,69
E4758,61,58,56,77,90,342,69
E5858,86,48,42,67,99,342,69
E9412,55,83,75,88,41,342,69
E4867,43,80,79,93,47,342,69
E5891,70,86,76,55,55,342,69
E4894,52,50,87,85,68,342,69
E0848,43,84,70,58,87,342,69
E6180,72,50,70,82,68,342,69
E1960,76,81,61,80,44,342,69
E7809,56,90,60,41,95,342,69
E1049,68,59,64,71,80,342,69
E9774,59,69,62,85,67,342,69
E0799,56,51,50,96,89,342,69
E7725,69,56,58,63,96,342,69
E6713,93,64,44,48,93,342,69
E0546,53,90,75,81,43,342,69
E5081,66,79,47,92,58,342,69
E8255,96,62,90,51,43,342,69
E8403,61,75,64,53,89,342,69
E6864,78,98,46,69,51,342,69
E6819,48,70,60,71,93,342,69
E4004,42,52,88,100,60,342,69
E5868,75,76,68,77,46,342,69
E1997,53,72,44,85,88,342,69
E6649,87,97,68,42,48,342,69
E6135,92,83,64,49,54,342,69
E0893,72,52,86,87,45,342,69
E1816,46,66,60,88,82,342,69
E3119,42,92,43,74,91,342,69
E2792,49,64,57,87,85,342,69
E5220,69,73,98,61,41,342,69
E6355,79,42,87,92,42,342,69
E8207,48,85,79,51,79,342,69
E8283,72,52,99,48,71,342,69
E4167,88,53,57,94,50,342,69
E0079,81,45,48,92,76,342,69
E1248,97,69,52,82,42,342,69
E5483,43,65,72,96,66,342,69
E8981,57,41,71,87,86,342,69
E8828,77,45,68,58,94,342,69
E7498,57,96,61,45,83,342,69
E1715,87,63,62,53,77,342,69
E8119,58,57,73,75,79,342,69
E0794,71,80,40,89,62,342,69
E9123,54,73,44,88,83,342,69
E4990,47,68,96,56,75,342,69
E7409,94,43,82,60,63,342,69
E5842,43,40,81,90,88,342,69
E4724,52,73,82,86,49,342,69
E6582,68,99,50,84,40,341,69
E5016,47,75,65,78,76,341,69
E0446,71,86,45,84,55,341,69
E7908,78,41,71,68,83,341,69
E9434,72,67,40,85,77,341,69
E5807,56,66,100,61,58,341,69
E7281,73,96,51,47,74,341,69
E1711,89,82,40,49,81,341,69
E0867,73,44,68,94,62,341,69
E7770,72,63,97,47,62,341,69
E4482,61,69,79,86,46,341,69
E0531,83,80,58,68,52,341,69
E2501,74,42,73,79,73,341,69
E1434,48,50,93,80,70,341,69
E3644,48,46,78,95,74,341,69
E4491,60,94,48,47,92,341,69
E4972,44,66,80,79,72,341,69
E0949,53,71,86,44,87,341,69
E1690,74,57,55,90,65,341,69
E1000,81,66,58,54,82,341,69
E2693,95,74,62,51,59,341,69
E4719,70,55,68,57,91,341,69
E4980,98,80,51,51,61,341,69
E9660,44,84,98,41,74,341,69
E0951,67,95,47,70,62,341,69
E4819,52,50,87,88,64,341,69
E5035,78,73,47,100,43,341,69
E0065,91,57,66,48,79,341,69
E2529,68,54,53,74,92,341,69
E4854,95,66,48,82,50,341,69
E4389,61,77,57,71,75,341,69
E1309,42,54,96,70,79,341,69
E5617,78,61,89,68,45,341,69
E3428,95,100,40,62,44,341,69
E9306,76,41,96,51,77,341,69
E3656,52,76,71,52,90,341,69
E6100,91,66,47,68,69,341,69
E6188,66,73,94,43,65,341,69
E2215,90,48,65,91,47,341,69
E9287,88,44,97,50,62,341,69
E0468,64,56,63,91,67,341,69
E6751,58,45,79,61,98,341,69
E5112,52,93,84,61,51,341,69
E1580,77,55,95,65,49,341,69
E4681,43,97,57,93,51,341,69
E5131,44,88,87,75,47,341,69
E9519,60,73,63,82,63,341,69
E8976,99,88,42,42,70,341,69
E4449,56,60,63,89,73,341,69
E6879,69,99,44,50,79,341,69
E5716,58,65,58,91,69,341,69
E4509,69,82,48,59,83,341,69
E6884,80,42,71,72,76,341,69
E5782,59,78,62,62,80,341,69
E0238,80,72,52,86,51,341,69
E4748,95,61,43,82,60,341,69
E4324,63,89,74,65,50,341,69
E6747,86,44,76,67,68,341,69
E9906,80,84,52,83,42,341,69
E4286,72,82,96,44,47,341,69
E1614,100,46,93,46,56,341,69
E5708,76,79,54,82,50,341,69
E4017,83,66,77,49,66,341,69
E1439,77,75,91,43,55,341,69
E1434,71,71,92,54,53,341,69
E3064,59,61,83,41,96,340,68
E5698,61,50,99,71,59,340,68
E0244,45,94,59,95,47,340,68
E7601,57,83,78,71,51,340,68
E7778,98,52,75,46,69,340,68
E2500,51,74,59,65,91,340,68
E5463,63,80,69,68,60,340,68
E4593,42,81,66,59,92,340,68
E5038,93,41,50,81,75,340,68
E7050,48,62,76,74,80,340,68
E6654,92,41,45,71,91,340,68
E3034,78,85,41,92,44,340,68
E8890,70,47,73,77,73,340,68
E1967,84,66,45,100,45,340,68
E2799,87,65,54,78,56,340,68
E4863,42,85,89,47,77,340,68
E7599,58,91,48,59,84,340,68
E4607,93,83,55,50,59,340,68
E8179,50,98,71,75,46,340,68
E7232,60,83,47,67,83,340,68
E6782,56,69,71,91,53,340,68
E9948,49,63,97,42,89,340,68
E4889,78,60,68,47,87,340,68
E6485,42,66,68,82,82,340,68
E7658,77,87,59,52,65,340,68
E0116,48,70,82,84,56,340,68
E9657,57,40,100,93,50,340,68
E7307,58,53,77,82,70,340,68
E1142,63,47,78,97,55,340,68
E1102,78,58,89,54,61,340,68
E7013,97,49,43,60,91,340,68
E5782,66,72,81,49,72,340,68
E7129,47,93,79,57,64,340,68
E1067,78,50,89,41,82,340,68
E2746,79,78,89,54,40,340,68
E8061,86,65,75,49,65,340,68
E7582,59,71,63,71,76,340,68
E3926,91,57,79,40,73,340,68
E8992,78,62,62,74,63,339,68
E4817,59,78,83,51,68,339,68
E5944,68,57,92,48,74,339,68
E3946,47,73,100,56,63,339,68
E7484,52,80,51,80,76,339,68
E8035,89,48,51,87,64,339,68
E6771,46,97,65,52,79,339,68
E5039,49,57,96,43,94,339,68
E4942,50,96,56,86,51,339,68
E3546,98,42,67,58,74,339,68
E8945,48,63,77,54,97,339,68
E2686,88,47,78,54,72,339,68
E9745,44,65,80,96,54,339,68
E9008,41,94,52,78,74,339,68
E1578,90,52,90,41,66,339,68
E7711,69,43,80,61,86,339,68
E9605,63,62,99,55,60,339,68
E0929,42,60,69,84,84,339,68
E4622,73,93,43,51,79,339,68
E1477,44,41,88,88,78,339,68
E1226,55,93,60,60,71,339,68
E9414,62,66,76,57,78,339,68
E4214,85,50,68,83,53,339,68
E3576,89,63,74,64,49,339,68
E3985,59,91,55,86,48,339,68
E1990,65,44,73,88,69,339,68
E4133,71,48,77,53,90,339,68
E1529,50,78,69,90,52,339,68
E4326,76,97,51,40,75,339,68
E3570,72,46,48,88,85,339,68
E9876,73,41,95,54,76,339,68
E6924,73,75,69,76,46,339,68
E4741,72,53,86,44,84,339,68
E0917,58,47,87,68,79,339,68
E0935,62,78,60,93,46,339,68
E5663,58,89,81,52,59,339,68
E0926,59,78,46,72,84,339,68
E2163,89,47,67,59,77,339,68
E8515,54,43,63,88,91,339,68
E2944,70,88,74,43,64,339,68
E4425,41,45,90,79,84,339,68
E0629,83,67,55,62,72,339,68
E7598,66,40,95,53,84,338,68
E9876,98,40,81,54,65,338,68
E5641,58,42,86,85,67,338,68
E5866,55,88,57,44,94,338,68
E8562,46,45,76,97,74,338,68
E3242,41,77,53,71,96,338,68
E9265,99,40,76,79,44,338,68
E1009,52,48,83,94,61,338,68
E7637,55,47,83,82,71,338,68
E9964,51,89,99,40,59,338,68
E0922,65,72,40,99,62,338,68
E4655,64,95,48,57,74,338,68
E6732,87,48,61,96,46,338,68
E4236,80,96,44,41,77,338,68
E4237,50,65,93,53,77,338,68
E7843,93,46,43,96,60,338,68
E4382,67,40,61,95,75,338,68
E4033,84,44,95,54,61,338,68
E5786,83,43,98,50,64,338,68
E7271,56,67,77,86,52,338,68
E9775,85,92,66,40,55,338,68
E1669,49,71,82,94,42,338,68
E6794,93,54,80,70,41,338,68
E4389,41,67,76,61,93,338,68
E8103,66,67,64,63,78,338,68
E0526,64,65,92,52,65,338,68
E7269,70,91,46,77,54,338,68
E0941,49,91,80,43,75,338,68
E7414,67,64,52,64,91,338,68
E6615,88,95,55,58,42,338,68
E4980,76,93,81,42,46,338,68
E1946,54,90,72,81,41,338,68
E0948,44,98,40,68,88,338,68
E4549,64,50,74,84,66,338,68
E4525,100,99,49,47,43,338,68
E1984,76,56,74,85,47,338,68
E0551,96,40,99,50,53,338,68
E5499,61,90,80,59,48,338,68
E4116,59,67,47,79,86,338,68
E4372,58,51,86,93,50,338,68
E9801,62,40,97,61,78,338,68
E8519,72,48,94,56,68,338,68
E5989,85,79,45,44,85,338,68
E1915,62,86,67,50,73,338,68
E4859,78,52,73,82,53,338,68
E8331,90,63,75,60,50,338,68
E7079,81,40,68,82,67,338,68
E9477,94,73,40,51,80,338,68
E7203,95,87,53,55,48,338,68
E0800,48,58,68,81,83,338,68
E4909,80,41,82,71,64,338,68
E4727,59,51,79,50,99,338,68
E0092,57,78,68,87,48,338,68
E8098,73,41,72,95,57,338,68
E1285,88,67,84,57,42,338,68
E4780,41,62,83,81,71,338,68
E4946,79,93,71,51,44,338,68
E4110,46,40,87,98,66,337,68
E8009,60,68,95,48,66,337,68
E3888,62,87,86,42,60,337,68
E9755,86,66,49,56,80,337,68
E3770,48,85,52,52,100,337,68
E3910,48,67,91,79,52,337,68
E4228,90,88,42,43,74,337,68
E3754,57,59,86,64,71,337,68
E9863,55,98,42,57,85,337,68
E5712,55,93,81,51,57,337,68
E6368,50,92,63,49,83,337,68
E6954,88,77,41,48,83,337,68
E6586,65,53,77,94,48,337,68
E2231,53,59,67,60,98,337,68
E2834,73,66,41,58,99,337,68
E9624,71,65,86,44,71,337,68
E7600,51,71,50,88,77,337,68
E4804,91,65,45,89,47,337,68
E0174,83,75,58,61,60,337,68
E0274,80,61,50,55,91,337,68
E6124,60,68,63,68,78,337,68
E7058,82,88,61,49,57,337,68
E0699,48,100,94,44,51,337,68
E7670,56,47,89,76,69,337,68
E7986,96,44,75,43,79,337,68
E3258,71,62,74,49,81,337,68
E6482,46,91,70,68,62,337,68
E3546,72,43,87,77,58,337,68
E3679,56,81,81,67,52,337,68
E4017,63,80,57,51,86,337,68
E0611,99,42,68,79,49,337,68
E8895,65,56,68,89,59,337,68
E6367,64,82,60,47,84,337,68
E9930,57,58,96,42,84,337,68
E5990,74,96,41,61,65,337,68
E3032,95,50,47,73,72,337,68
E9465,93,60,83,49,52,337,68
E9911,71,46,84,55,81,337,68
E3655,41,75,79,96,46,337,68
E5095,69,62,100,45,61,337,68
E1767,82,75,51,56,73,337,68
E3111,78,51,77,59,72,337,68
E6194,53,43,90,78,73,337,68
E5372,71,62,40,65,98,336,68
E3982,47,68,83,72,66,336,68
E0097,42,62,51,88,93,336,68
E4002,67,90,46,46,87,336,68
E6994,65,74,59,48,90,336,68
E1909,89,72,44,79,52,336,68
E6522,68,48,86,43,91,336,68
E8689,49,59,57,81,90,336,68
E3445,75,46,62,53,100,336,68
E9946,44,94,75,48,75,336,68
E4207,54,53,82,69,78,336,68
E3502,72,77,51,58,78,336,68
E9231,63,76,78,61,58,336,68
E2056,97,58,66,62,53,336,68
E2691,55,95,79,62,45,336,68
E5523,85,53,46,66,86,336,68
E7412,69,57,92,47,71,336,68
E8246,66,84,40,65,81,336,68
E2156,52,87,56,57,84,336,68
E8136,41,76,64,93,62,336,68
E1199,56,79,74,70,57,336,68
E9379,100,62,55,61,58,336,68
E0235,80,80,56,70,50,336,68
E4586,58,60,87,71,60,336,68
E1258,52,97,59,44,84,336,68
E0709,43,87,81,58,67,336,68
E4391,45,83,50,92,66,336,68
E6539,47,73,41,94,81,336,68
E4858,54,63,89,67,63,336,68
E1792,52,93,83,45,63,336,68
E7836,62,82,45,79,68,336,68
E5954,90,53,92,44,57,336,68
E4073,51,52,81,69,83,336,68
E0961,63,81,44,93,55,336,68
E7841,80,55,48,95,58,336,68
E5068,81,50,65,52,88,336,68
E4258,98,66,56,67,49,336,68
E9713,53,57,72,69,85,336,68
E3037,75,90,64,61,46,336,68
E8347,49,94,60,51,82,336,68
E4916,77,48,79,42,90,336,68
E3531,83,58,43,97,55,336,68
E5123,78,82,55,73,48,336,68
E8603,64,77,69,79,47,336,68
E6022,78,61,49,48,100,336,68
E3839,73,57,81,81,44,336,68
E4316,41,80,44,84,87,336,68
E1868,65,49,91,90,41,336,68
E2057,49,68,97,48,74,336,68
E5890,72,50,56,96,62,336,68
E9108,91,66,50,85,44,336,68
E0316,58,75,91,67,44,335,67
E7032,96,89,46,64,40,335,67
E0014,86,42,51,71,85,335,67
E2838,66,51,88,82,48,335,67
E8390,97,66,59,63,50,335,67
E2981,49,55,50,98,83,335,67
E1723,84,57,52,73,69,335,67
E3490,67,76,47,49,96,335,67
E7400,74,73,62,74,52,335,67
E9232,66,98,74,47,50,335,67
E5440,45,74,87,65,64,335,67
E4034,76,48,61,75,75,335,67
E4773,44,85,56,71,79,335,67
E7122,82,80,50,81,42,335,67
E8950,64,48,83,56,84,335,67
E8991,55,95,40,89,56,335,67
E0699,52,48,100,82,53,335,67
E4549,62,90,77,63,43,335,67
E1080,66,74,50,87,58,335,67
E8222,71,55,98,50,61,335,67
E3100,69,58,73,88,47,335,67
E8490,78,43,76,96,42,335,67
E9166,41,48,88,61,97,335,67
E6394,46,44,97,70,78,335,67
E5957,58,89,69,64,55,335,67
E0412,57,73,64,69,72,335,67
E0584,85,70,56,67,57,335,67
E1946,62,44,84,63,82,335,67
E8153,69,88,45,48,85,335,67
E2881,56,72,75,42,90,335,67
E9385,60,62,49,79,85,335,67
E1100,49,61,100,81,44,335,67
E6164,83,62,50,68,72,335,67
E7588,71,47,78,90,49,335,67
E1559,74,61,81,63,56,335,67
E4778,71,62,89,59,54,335,67
E2062,71,53,40,77,94,335,67
E7880,58,82,76,72,47,335,67
E7685,80,52,77,62,64,335,67
E1704,49,56,99,80,51,335,67
E3476,96,88,43,41,67,335,67
E0443,78,70,92,46,49,335,67
E7337,64,70,79,57,65,335,67
E1852,85,72,73,62,43,335,67
E6741,90,63,69,54,59,335,67
E2202,93,87,47,67,41,335,67
E8132,59,62,99,74,41,335,67
E2340,78,43,41,93,80,335,67
E0712,69,50,79,75,62,335,67
E2023,100,43,61,85,46,335,67
E0219,73,47,75,59,81,335,67
E4163,73,49,85,72,56,335,67
E1387,81,63,78,57,56,335,67
E6895,89,43,67,59,77,335,67
E9588,73,76,64,46,76,335,67
E9612,50,71,76,64,74,335,67
E9243,40,57,82,89,67,335,67
E4545,46,88,81,49,70,334,67
E9789,48,78,82,84,42,334,67
E6083,43,83,99,53,56,334,67
E5625,88,62,53,60,71,334,67
E0690,82,68,67,43,74,334,67
E8631,68,78,54,71,63,334,67
E5722,69,43,74,73,75,334,67
E5673,95,86,43,59,51,334,67
E3835,59,52,91,83,49,334,67
E4320,69,77,46,99,43,334,67
E5607,77,54,54,57,92,334,67
E6958,70,62,63,48,91,334,67
E3359,54,77,77,69,57,334,67
E9062,58,76,75,57,68,334,67
E7912,54,73,87,73,47,334,67
E7215,42,79,79,46,88,334,67
E2641,90,77,57,67,43,334,67
E7380,64,58,62,56,94,334,67
E8596,63,73,59,47,92,334,67
E7501,55,54,51,89,85,334,67
E5831,88,48,82,76,40,334,67
E1891,43,94,49,100,48,334,67
E2925,61,77,71,61,64,334,67
E1440,60,45,95,65,69,334,67
E7363,69,60,67,45,93,334,67
E7746,42,82,53,73,84,334,67
E2805,83,43,95,70,43,334,67
E6948,57,73,61,89,54,334,67
E7101,47,65,80,70,72,334,67
E1887,85,52,47,84,66,334,67
E5637,93,97,53,43,48,334,67
E6067,83,61,52,49,89,334,67
E6496,67,66,45,95,61,334,67
E1585,43,46,77,71,97,334,67
E0376,65,54,63,72,80,334,67
E3021,74,50,85,51,74,334,67
E4055,55,67,70,69,73,334,67
E7443,47,85,62,58,82,334,67
E9112,67,75,42,50,100,334,67
E6299,57,56,93,60,68,334,67
E7252,61,71,48,83,71,334,67
E1323,51,45,100,96,42,334,67
E4058,100,41,76,65,52,334,67
E6729,48,91,62,41,92,334,67
E0733,91,57,89,55,42,334,67
E9244,63,86,44,65,76,334,67
E3230,70,53,41,90,80,334,67
E3756,75,95,67,55,42,334,67
E0968,41,95,78,47,73,334,67
E5825,71,50,100,65,48,334,67
E0767,48,65,49,99,73,334,67
E5763,82,69,67,66,50,334,67
E3495,78,77,41,64,73,333,67
E7936,67,51,54,73,88,333,67
E6088,46,45,64,83,95,333,67
E9489,60,83,62,78,50,333,67
E8253,78,55,72,65,63,333,67
E7054,58,86,59,80,50,333,67
E5750,98,46,47,98,44,333,67
E5015,59,66,75,51,82,333,67
E9801,48,40,85,87,73,333,67
E3641,80,95,48,62,48,333,67
E9032,65,59,63,94,52,333,67
E4748,44,89,65,87,48,333,67
E1063,68,42,78,65,80,333,67
E7056,93,43,77,73,47,333,67
E8467,94,69,42,52,76,333,67
E2025,93,78,71,42,49,333,67
E1957,49,88,52,98,46,333,67
E5975,63,73,55,96,46,333,67
E9168,85,58,57,86,47,333,67
E4870,47,42,64,81,99,333,67
E7128,43,85,65,52,88,333,67
E4444,98,65,51,44,75,333,67
E2080,75,54,55,83,66,333,67
E5174,53,94,88,48,50,333,67
E1822,56,83,47,65,82,333,67
E9401,47,56,81,71,78,333,67
E7644,73,60,95,50,55,333,67
E2078,72,86,63,47,65,333,67
E5934,59,76,50,91,57,333,67
E2528,87,64,66,76,40,333,67
E2911,83,58,62,58,72,333,67
E5143,55,72,64,100,42,333,67
E6876,55,93,57,75,53,333,67
E4019,43,94,59,46,91,333,67
E2775,63,47,70,55,98,333,67
E6468,89,41,54,51,98,333,67
E3168,69,98,56,51,59,333,67
E3455,68,84,56,53,72,333,67
E9777,79,53,46,97,58,333,67
E5800,46,85,43,79,80,333,67
E5653,74,46,84,56,73,333,67
E2230,46,75,46,87,79,333,67
E6850,69,79,89,44,52,333,67
E4472,71,54,70,62,76,333,67
E1788,85,52,73,67,56,333,67
E9130,81,63,65,43,81,333,67
E3321,69,80,54,71,59,333,67
E4346,52,42,56,94,89,333,67
E3659,58,48,75,93,59,333,67
E7440,41,88,72,40,92,333,67
E0375,54,79,79,68,53,333,67
E8741,97,57,49,85,45,333,67
E9055,44,67,89,70,63,333,67
E0729,98,69,63,54,49,333,67
E3772,59,58,41,91,84,333,67
E5250,49,73,45,81,85,333,67
E4102,87,46,65,72,63,333,67
E2338,96,50,63,79,45,333,67
E3818,84,74,49,75,51,333,67
E4486,86,56,49,68,73,332,67
E7342,68,74,84,64,42,332,67
E6550,66,47,69,77,73,332,67
E5270,90,73,42,85,42,332,67
E3502,71,93,48,43,77,332,67
E2320,41,92,66,40,93,332,67
E9665,66,89,40,91,46,332,67
E1356,81,43,70,50,88,332,67
E6083,45,71,84,70,62,332,67
E0821,76,72,50,86,48,332,67
E4175,90,86,40,49,67,332,67
E3607,73,86,50,66,57,332,67
E5365,74,61,67,55,75,332,67
E7084,44,65,55,72,96,332,67
E8249,100,61,40,72,59,332,67
E5034,53,55,67,100,57,332,67
E5933,48,72,46,75,91,332,67
E8850,43,68,81,100,40,332,67
E4238,88,57,70,68,49,332,67
E9412,54,67,42,95,74,332,67
E4328,66,45,99,73,49,332,67
E5940,73,56,72,49,82,332,67
E1102,52,97,53,59,71,332,67
E8287,68,55,56,95,58,332,67
E9472,80,62,50,68,72,332,67
E1568,62,63,95,64,48,332,67
E3973,66,56,53,71,86,332,67
E8599,42,74,64,100,52,332,67
E3876,57,62,49,82,82,332,67
E6597,48,77,55,53,99,332,67
E5961,53,93,60,71,55,332,67
E3828,56,58,53,78,87,332,67
E4685,49,66,67,86,64,332,67
E9886,47,88,67,52,78,332,67
E5465,66,47,95,76,48,332,67
E5247,56,100,60,75,41,332,67
E1119,51,89,86,50,56,332,67
E4810,47,94,41,94,56,332,67
E4218,51,92,78,41,70,332,67
E7201,54,46,73,85,74,332,67
E2220,72,59,81,65,55,332,67
E3928,70,50,81,72,59,332,67
E9747,45,88,90,60,49,332,67
E9436,53,66,71,50,92,332,67
E5881,46,82,76,86,42,332,67
E3061,71,55,48,98,60,332,67
E8264,96,53,42,83,58,332,67
E2450,78,72,42,85,55,332,67
E2873,91,44,71,80,45,331,67
E8246,60,65,66,91,49,331,67
E3921,77,100,40,68,46,331,67
E8354,50,60,79,98,44,331,67
E8435,52,62,91,61,65,331,67
E8784,92,46,92,60,41,331,67
E7752,82,74,42,77,56,331,67
E6764,90,95,60,42,44,331,67
E4907,91,73,46,42,79,331,67
E7410,40,66,88,89,48,331,67
E5882,51,52,51,80,97,331,67
E9017,80,60,93,45,53,331,67
E0190,77,79,40,44,91,331,67
E9786,99,44,67,69,52,331,67
E3846,47,54,91,77,62,331,67
E8779,49,74,46,98,64,331,67
E3240,75,63,52,86,55,331,67
E0000,41,45,100,48,97,331,67
E2900,51,59,71,96,54,331,67
E8390,93,47,78,50,63,331,67
E3435,46,95,45,59,86,331,67
E6715,47,50,52,83,99,331,67
E4136,44,97,57,85,48,331,67
E9007,78,90,54,49,60,331,67
E8685,100,50,45,88,48,331,67
E0642,88,47,78,57,61,331,67
E0349,61,84,54,50,82,331,67
E4302,63,64,54,50,100,331,67
E5126,49,90,85,60,47,331,67
E2057,76,76,74,53,52,331,67
E4350,43,47,99,98,44,331,67
E0938,53,68,55,67,88,331,67
E1664,94,60,42,64,71,331,67
E0749,41,98,74,73,45,331,67
E3377,45,78,47,74,87,331,67
E0344,78,70,46,63,74,331,67
E9707,68,74,58,69,62,331,67
E8469,56,59,48,70,98,331,67
E9585,72,78,88,40,53,331,67
E8837,69,84,45,90,43,331,67
E8707,47,42,82,83,77,331,67
E5411,60,87,49,79,56,331,67
E9069,45,83,69,61,73,331,67
E1165,73,43,78,58,79,331,67
E1064,49,44,85,95,58,331,67
E2830,66,73,46,94,52,331,67
E5263,48,40,75,96,72,331,67
E6597,97,100,51,41,42,331,67
E9868,44,58,52,98,79,331,67
E0238,60,99,58,68,46,331,67
E7983,55,66,60,54,96,331,67
E5444,52,91,85,48,55,331,67
E5950,94,59,67,66,45,331,67
E1737,42,65,57,93,74,331,67
E2126,49,44,92,62,84,331,67
E3140,56,94,97,42,42,331,67
E9948,85,49,72,72,53,331,67
E2754,70,45,73,61,82,331,67
E6600,50,53,88,77,62,330,66
E9996,50,63,64,62,91,330,66
E6582,63,98,49,66,54,330,66
E4571,98,74,72,46,40,330,66
E8087,51,92,66,42,79,330,66
E0576,47,82,53,85,63,330,66
E8399,88,53,84,45,60,330,66
E5590,53,85,84,48,60,330,66
E1006,57,93,67,42,71,330,66
E5860,49,85,68,47,81,330,66
E7562,100,56,45,61,68,330,66
E7396,74,66,93,50,47,330,66
E5856,59,89,72,57,53,330,66
E0271,49,81,72,85,43,330,66
E5119,84,73,57,42,74,330,66
E3893,88,95,58,43,46,330,66
E1210,65,50,100,65,50,330,66
E9306,63,41,80,50,96,330,66
E8280,41,49,89,66,85,330,66
E5982,55,68,55,88,64,330,66
E4796,56,67,74,51,82,330,66
E0551,67,55,64,71,73,330,66
E2633,60,46,46,90,88,330,66
E8563,97,69,50,61,53,330,66
E2441,49,99,44,96,42,330,66
E2408,81,90,53,54,52,330,66
E2576,86,65,60,41,78,330,66
E1643,49,69,94,45,73,330,66
E0072,84,45,48,56,97,330,66
E9951,82,64,74,40,70,330,66
E6325,55,85,89,54,47,330,66
E9720,87,45,73,44,81,330,66
E7859,95,65,80,49,41,330,66
E3991,69,51,47,84,78,329,66
E3314,48,50,82,73,76,329,66
E3134,84,47,89,47,62,329,66
E8432,71,41,52,69,96,329,66
E3504,46,80,82,43,78,329,66
E3055,74,40,88,69,58,329,66
E6487,81,66,43,90,49,329,66
E9468,79,62,50,54,84,329,66
E4575,53,58,43,100,75,329,66
E8334,68,56,53,90,62,329,66
E6147,71,65,94,57,42,329,66
E9248,46,67,55,74,87,329,66
E6846,50,86,66,83,44,329,66
E4721,63,96,44,70,56,329,66
E4346,63,68,51,96,51,329,66
E3933,52,42,84,75,76,329,66
E4924,97,73,45,63,51,329,66
E4676,45,97,63,64,60,329,66
E1207,49,100,44,87,49,329,66
E5136,89,46,42,78,74,329,66
E0335,67,42,85,89,46,329,66
E7879,66,83,60,69,51,329,66
E3923,60,87,84,49,49,329,66
E8262,61,55,61,87,65,329,66
E4329,71,67,50,41,100,329,66
E7434,64,40,65,100,60,329,66
E5921,82,50,89,44,64,329,66
E0800,48,89,53,50,89,329,66
E1518,54,72,78,43,82,329,66
E6876,98,69,48,52,62,329,66
E5805,90,45,59,66,69,329,66
E2952,59,43,87,72,68,329,66
E3059,42,85,42,83,77,329,66
E3348,42,72,87,48,80,329,66
E7642,54,79,63,64,69,329,66
E6806,65,52,51,89,72,329,66
E9493,99,56,67,52,55,329,66
E5427,41,96,94,46,52,329,66
E8924,58,47,79,96,49,329,66
E8987,45,83,96,60,45,329,66
E2503,55,64,73,70,67,329,66
E6613,56,72,45,72,84,329,66
E0334,46,100,98,40,45,329,66
E1563,64,45,59,61,100,329,66
E3279,95,54,66,66,48,329,66
E2773,100,51,54,71,53,329,66
E6427,50,53,80,58,88,329,66
E3498,89,49,78,58,55,329,66
E1415,68,77,83,47,54,329,66
E5976,46,90,51,50,92,329,66
E0344,61,96,47,52,73,329,66
E3114,94,42,98,48,47,329,66
E7676,74,59,69,77,50,329,66
E1221,55,76,44,68,85,328,66
E7430,41,74,71,74,68,328,66
E4364,49,78,80,55,66,328,66
E3022,57,52,73,46,100,328,66
E1345,54,59,76,73,66,328,66
E3470,48,41,64,100,75,328,66
E7647,56,63,65,61,83,328,66
E0700,87,58,51,76,56,328,66
E2388,65,89,86,41,47,328,66
E2644,82,57,64,75,50,328,66
E6335,57,42,93,48,88,328,66
E0848,52,75,40,77,84,328,66
E9898,82,41,71,59,75,328,66
E2230,64,89,58,46,71,328,66
E9068,79,45,60,87,57,328,66
E9960,40,54,76,89,69,328,66
E0398,78,43,77,79,51,328,66
E7604,56,71,52,52,97,328,66
E7453,61,85,42,52,88,328,66
E9144,96,97,42,53,40,328,66
E7427,88,41,65,71,63,328,66
E0620,80,72,68,64,44,328,66
E0155,54,96,42,40,96,328,66
E7792,42,73,77,42,94,328,66
E2556,54,51,89,74,60,328,66
E8523,47,51,79,79,72,328,66
E0998,40,87,65,55,81,328,66
E1149,60,48,81,81,58,328,66
E5554,96,50,82,58,42,328,66
E1289,55,94,49,41,89,328,66
E9259,76,48,47,65,92,328,66
E2311,44,85,48,52,99,328,66
E6744,53,70,42,80,83,328,66
E4900,55,60,85,85,43,328,66
E6076,91,46,70,44,77,328,66
E5368,98,40,49,52,89,328,66
E2788,83,59,51,50,85,328,66
E4731,85,88,52,40,63,328,66
E8074,60,72,56,47,93,328,66
E5963,44,97,82,59,46,328,66
E9253,46,46,88,89,59,328,66
E6386,77,82,58,57,54,328,66
E7303,65,50,97,61,55,328,66
E5086,97,43,66,43,78,327,66
E9806,54,41,89,86,57,327,66
E6779,72,63,61,75,56,327,66
E3100,41,87,52,79,68,327,66
E2168,51,51,100,62,63,327,66
E9236,42,98,50,87,50,327,66
E7412,51,65,47,96,68,327,66
E8332,55,44,96,60,72,327,66
E8602,48,76,41,76,86,327,66
E7079,53,70,51,99,54,327,66
E3792,97,55,84,44,47,327,66
E7614,44,86,55,96,46,327,66
E1874,64,48,95,58,62,327,66
E9985,99,76,55,49,48,327,66
E7710,96,46,73,70,42,327,66
E0416,44,56,71,72,84,327,66
E0043,80,90,45,41,71,327,66
E9543,53,65,61,100,48,327,66
E3286,48,41,99,87,52,327,66
E9174,48,47,71,82,79,327,66
E5263,100,48,63,43,73,327,66
E7988,61,59,75,59,73,327,66
E1198,80,58,54,94,41,327,66
E9247,73,49,59,49,97,327,66
E4882,51,55,100,81,40,327,66
E0366,40,46,98,100,43,327,66
E3961,78,55,81,42,71,327,66
E9745,71,56,81,70,49,327,66
E3455,75,52,57,92,51,327,66
E3115,49,40,80,93,65,327,66
E4977,88,56,53,90,40,327,66
E6132,50,68,91,47,71,327,66
E1367,50,82,57,90,48,327,66
E7520,61,72,62,58,74,327,66
E9700,59,69,43,84,72,327,66
E4969,68,96,58,55,50,327,66
E6878,52,48,90,60,77,327,66
E8521,41,79,70,78,59,327,66
E4247,53,71,80,74,49,327,66
E5764,46,86,94,50,51,327,66
E7241,73,52,79,40,83,327,66
E5686,59,50,50,98,70,327,66
E4163,100,48,51,83,45,327,66
E9871,66,72,61,72,56,327,66
E7700,42,95,88,48,54,327,66
E1261,95,85,52,55,40,327,66
E9626,63,47,75,82,60,327,66
E2987,48,46,75,91,67,327,66
E2472,52,84,63,55,73,327,66
E3279,86,90,49,62,40,327,66
E6802,77,45,89,58,58,327,66
E5265,92,57,82,54,42,327,66
E0478,75,47,61,53,91,327,66
E8690,45,60,96,43,83,327,66
E5775,49,87,47,92,52,327,66
E4719,59,71,48,90,59,327,66
E0422,88,63,63,42,71,327,66
E8952,97,68,67,53,42,327,66
E8051,86,70,45,69,57,327,66
E0368,74,58,43,67,85,327,66
E8603,58,72,91,45,60,326,66
E5883,64,59,51,67,85,326,66
E8561,81,76,48,64,57,326,66
E8201,94,50,83,49,50,326,66
E9379,68,95,63,60,40,326,66
E7840,62,41,56,91,76,326,66
E1912,57,44,87,88,50,326,66
E2502,44,66,76,96,44,326,66
E7795,82,50,87,41,66,326,66
E0547,45,93,52,87,49,326,66
E3710,67,83,72,57,47,326,66
E1620,80,92,44,59,51,326,66
E5836,43,54,79,88,62,326,66
E5422,55,66,67,49,89,326,66
E9645,40,67,92,40,87,326,66
E6861,91,45,98,42,50,326,66
E8671,78,68,48,77,55,326,66
E8252,59,97,41,54,75,326,66
E4113,71,87,45,74,49,326,66
E5491,82,61,48,43,92,326,66
E7528,87,68,53,64,54,326,66
E9922,47,98,55,79,47,326,66
E0600,70,79,61,45,71,326,66
E4276,86,79,43,68,50,326,66
E5328,71,43,53,84,75,326,66
E9736,41,80,80,47,78,326,66
E6992,65,78,81,55,47,326,66
E7431,87,63,49,51,76,326,66
E7209,40,90,66,81,49,326,66
E7453,97,41,88,46,54,326,66
E1425,80,98,43,43,62,326,66
E6792,81,89,51,44,61,326,66
E9544,51,91,78,63,43,326,66
E4057,69,73,74,52,58,326,66
E0921,42,55,83,85,61,326,66
E8134,72,72,60,64,58,326,66
E1518,60,52,74,91,49,326,66
E5302,95,72,52,63,44,326,66
E6759,82,68,59,77,40,326,66
E9997,46,75,42,63,100,326,66
E1616,99,55,49,44,79,326,66
E7754,48,61,68,74,75,326,66
E6717,60,73,61,47,85,326,66
E5441,51,44,90,51,89,325,65
E3902,58,58,69,81,59,325,65
E5339,75,63,68,53,66,325,65
E5103,61,83,40,97,44,325,65
E6036,54,42,88,55,86,325,65
E3378,96,50,64,69,46,325,65
E8600,56,49,55,96,69,325,65
E8653,48,73,79,66,59,325,65
E4303,59,43,75,85,63,325,65
E2986,57,70,70,58,70,325,65
E4028,81,52,42,69,81,325,65
E0074,83,49,46,79,68,325,65
E0777,84,46,79,46,70,325,65
E1859,80,52,56,89,48,325,65
E0059,85,55,87,46,52,325,65
E3761,71,76,57,53,68,325,65
E1553,62,76,60,86,41,325,65
E1461,99,71,48,46,61,325,65
E5614,77,60,51,86,51,325,65
E8561,87,56,72,53,57,325,65
E2814,71,67,64,77,46,325,65
E0024,89,61,55,65,55,325,65
E6216,43,63,73,50,96,325,65
E9463,90,62,46,49,78,325,65
E0714,99,40,85,57,44,325,65
E6612,48,71,79,83,44,325,65
E6880,41,73,96,51,64,325,65
E8689,74,59,57,60,74,324,65
E6045,50,66,93,66,49,324,65
E1139,81,43,79,76,45,324,65
E6085,44,88,46,84,62,324,65
E9450,45,57,62,93,67,324,65
E4994,67,49,67,89,52,324,65
E4368,55,98,42,54,75,324,65
E2116,59,97,52,62,54,324,65
E0125,46,77,72,82,47,324,65
E1704,59,92,50,44,79,324,65
E2038,64,49,81,55,75,324,65
E8205,61,61,81,48,73,324,65
E3204,71,61,48,82,62,324,65
E3569,40,58,89,66,71,324,65
E9320,67,53,64,53,87,324,65
E3026,56,45,86,90,47,324,65
E2123,40,84,61,74,65,324,65
E9978,86,42,75,48,73,324,65
E6265,48,50,40,88,98,324,65
E7597,61,57,65,55,86,324,65
E4790,100,40,46,69,69,324,65
E6029,77,68,68,65,46,324,65
E3320,84,42,57,62,79,324,65
E2130,56,75,64,83,46,324,65
E0194,64,56,46,80,78,324,65
E5260,90,50,42,60,82,324,65
E2063,77,47,53,70,77,324,65
E7727,59,51,60,65,89,324,65
E4339,62,77,70,63,52,324,65
E3921,43,51,63,80,87,324,65
E9849,61,50,63,74,76,324,65
E6527,46,52,41,86,99,324,65
E0962,67,61,60,76,60,324,65
E8301,61,48,55,93,67,324,65
E7422,83,42,84,73,42,324,65
E4338,72,52,83,73,44,324,65
E3559,86,72,42,48,76,324,65
E5307,43,93,78,69,41,324,65
E0894,56,94,89,44,41,324,65
E5315,91,44,43,96,50,324,65
E8651,68,62,84,64,46,324,65
E0699,66,43,95,58,61,323,65
E9644,91,58,46,73,55,323,65
E2516,43,82,77,56,65,323,65
E4327,44,58,96,56,69,323,65
E4762,62,77,43,89,52,323,65
E2915,69,68,44,42,100,323,65
E2651,77,41,64,80,61,323,65
E1743,43,92,48,84,56,323,65
E6631,46,81,64,57,75,323,65
E4049,56,74,62,55,76,323,65
E5869,83,62,49,82,47,323,65
E9693,72,71,72,55,53,323,65
E4967,84,60,53,52,74,323,65
E4872,55,80,47,71,70,323,65
E2237,74,49,52,96,52,323,65
E7415,89,69,44,60,61,323,65
E0306,93,41,43,93,53,323,65
E6944,80,59,48,60,76,323,65
E6368,70,41,81,43,88,323,65
E1907,58,47,61,92,65,323,65
E4343,63,57,78,85,40,323,65
E0487,68,43,83,84,45,323,65
E9376,71,56,55,100,41,323,65
E7466,54,82,41,60,86,323,65
E9585,75,74,83,48,43,323,65
E9264,52,63,52,94,62,323,65
E8301,54,78,68,75,48,323,65
E0608,57,79,57,64,66,323,65
E6692,77,42,79,69,56,323,65
E1254,49,52,70,81,71,323,65
E1663,80,68,71,60,44,323,65
E2671,57,79,80,52,55,323,65
E0230,91,50,91,42,49,323,65
E6923,90,41,72,69,51,323,65
E5057,64,46,83,48,82,323,65
E8738,86,44,78,64,51,323,65
E1996,83,42,72,66,60,323,65
E0159,62,40,72,94,55,323,65
E9283,60,63,82,40,78,323,65
E6157,59,53,98,62,50,322,65
E3993,75,40,81,75,51,322,65
E2088,94,55,54,42,77,322,65
E7958,63,87,49,81,42,322,65
E4068,40,70,62,99,51,322,65
E5136,71,63,47,86,55,322,65
E7898,60,65,98,42,57,322,65
E5903,73,75,47,54,73,322,65
E2065,51,95,67,44,65,322,65
E0187,51,71,86,53,61,322,65
E6822,73,46,73,60,70,322,65
E5932,100,40,51,49,82,322,65
E5508,96,52,77,51,46,322,65
E9049,87,56,70,52,57,322,65
E1154,53,88,75,49,57,322,65
E4716,49,40,88,81,64,322,65
E4173,63,43,99,77,40,322,65
E8081,59,47,96,66,54,322,65
E2106,46,44,52,84,96,322,65
E3354,76,78,52,50,66,322,65
E8140,89,49,66,41,77,322,65
E7565,93,48,46,74,61,322,65
E6520,48,63,63,92,56,322,65
E3056,43,87,52,99,41,322,65
E6278,95,54,42,42,89,322,65
E4109,65,55,88,55,59,322,65
E5447,46,85,40,51,100,322,65
E2948,44,86,62,74,56,322,65
E9047,48,95,62,58,59,322,65
E8922,70,55,81,49,67,322,65
E1142,60,83,66,53,60,322,65
E0534,73,66,61,64,58,322,65
E8311,40,90,95,45,52,322,65
E4580,43,86,46,79,68,322,65
E9514,49,77,49,70,77,322,65
E2048,50,67,87,63,55,322,65
E9150,40,70,94,76,42,322,65
E6992,54,76,69,73,50,322,65
E2188,53,99,42,71,57,322,65
E4314,69,69,83,56,45,322,65
E9591,52,58,61,77,74,322,65
E2092,46,54,71,90,60,321,65
E5448,83,63,54,72,49,321,65
E6543,59,98,77,45,42,321,65
E2658,84,53,52,54,78,321,65
E7562,88,94,40,47,52,321,65
E4042,100,42,62,75,42,321,65
E0271,88,67,77,43,46,321,65
E2844,63,53,76,65,64,321,65
E6041,56,60,56,100,49,321,65
E3722,81,83,40,47,70,321,65
E6914,78,93,50,53,47,321,65
E4754,91,73,45,40,72,321,65
E4048,43,58,54,93,73,321,65
E8221,96,43,79,55,48,321,65
E3689,55,84,62,64,56,321,65
E0464,94,40,66,57,64,321,65
E4178,64,93,44,66,54,321,65
E5257,43,97,76,44,61,321,65
E1749,61,46,46,73,95,321,65
E6161,69,73,53,83,43,321,65
E0043,81,41,78,76,45,321,65
E9264,57,79,69,52,64,321,65
E7006,64,94,66,50,47,321,65
E7222,68,45,43,89,76,321,65
E4054,54,81,89,48,49,321,65
E3797,63,77,49,75,57,321,65
E1119,56,57,55,81,72,321,65
E5213,75,55,45,64,82,321,65
E8307,41,60,96,57,67,321,65
E6412,83,89,43,48,58,321,65
E9103,64,40,51,68,98,321,65
E3823,75,71,68,65,42,321,65
E2014,78,49,57,86,51,321,65
E2732,64,86,63,65,43,321,65
E4310,80,59,62,70,50,321,65
E8674,62,82,58,79,40,321,65
E1888,43,97,80,51,50,321,65
E5883,74,78,71,58,40,321,65
E0571,43,80,56,66,76,321,65
E0530,70,60,63,61,67,321,65
E0174,65,74,57,67,58,321,65
E0527,51,81,57,55,77,321,65
E8725,48,98,40,88,47,321,65
E3616,57,63,94,44,63,321,65
E7418,75,94,57,53,42,321,65
E0423,63,77,78,51,51,320,64
E9219,53,95,58,54,60,320,64
E6640,69,45,45,67,94,320,64
E6395,62,43,72,67,76,320,64
E9195,95,57,51,61,56,320,64
E5807,52,69,79,62,58,320,64
E0580,79,56,52,56,77,320,64
E5281,43,87,56,60,74,320,64
E8577,67,70,43,91,49,320,64
E4299,42,62,66,89,61,320,64
E9516,63,95,53,58,51,320,64
E0382,44,89,90,56,41,320,64
E1722,89,45,97,44,45,320,64
E9837,46,62,66,66,80,320,64
E9431,63,49,55,63,90,320,64
E0673,93,83,45,59,40,320,64
E6615,41,71,50,67,91,320,64
E7042,73,59,55,52,81,320,64
E2289,69,53,65,54,79,320,64
E2079,82,42,83,58,55,320,64
E2325,40,87,86,55,52,320,64
E0035,47,58,77,45,93,320,64
E0260,59,98,53,48,62,320,64
E9146,48,100,48,72,52,320,64
E3356,77,51,61,51,80,320,64
E3125,40,77,58,73,72,320,64
E2203,81,65,40,47,87,320,64
E1009,96,45,80,46,53,320,64
E0185,48,71,82,56,63,320,64
E2992,58,84,60,56,62,320,64
E4387,72,47,49,62,90,320,64
E6490,62,95,56,64,43,320,64
E0047,82,77,42,45,74,320,64
E3315,86,40,48,79,67,320,64
E9836,47,86,57,72,58,320,64
E6062,46,80,76,58,60,320,64
E7747,54,83,65,62,56,320,64
E6072,49,53,73,85,59,319,64
E8401,44,74,80,57,64,319,64
E1924,83,49,80,53,54,319,64
E8427,44,43,66,92,74,319,64
E4054,63,46,80,73,57,319,64
E5083,84,67,43,51,74,319,64
E1230,97,59,42,42,79,319,64
E4789,40,42,94,78,65,319,64
E4199,98,50,77,43,51,319,64
E5359,84,40,57,44,94,319,64
E4608,75,93,42,69,40,319,64
E2749,42,94,91,40,52,319,64
E7344,60,76,48,73,62,319,64
E8821,60,67,42,79,71,319,64
E5462,59,74,81,64,41,319,64
E3193,55,63,71,85,45,319,64
E8247,91,48,57,44,79,319,64
E6267,65,74,85,42,53,319,64
E4231,43,88,43,100,45,319,64
E8706,49,56,44,92,78,319,64
E1804,44,92,42,58,83,319,64
E4501,73,53,51,98,44,319,64
E3843,47,72,62,62,76,319,64
E2151,58,68,57,85,51,319,64
E4971,47,64,85,49,74,319,64
E7688,80,92,44,50,53,319,64
E4998,76,83,56,55,49,319,64
E0867,78,77,40,49,75,319,64
E3394,76,54,57,73,59,319,64
E6037,47,72,51,61,88,319,64
E2224,41,53,93,57,75,319,64
E5807,60,83,66,60,50,319,64
E6874,66,65,76,50,62,319,64
E4636,41,82,42,78,76,319,64
E9108,86,57,53,65,58,319,64
E8637,60,85,71,40,63,319,64
E9767,71,58,45,47,97,318,64
E4340,46,64,71,62,75,318,64
E5044,60,41,61,68,88,318,64
E8668,57,41,41,84,95,318,64
E5116,55,59,98,52,54,318,64
E8809,56,76,44,80,62,318,64
E9813,88,46,61,47,76,318,64
E8195,55,67,82,55,59,318,64
E2385,41,69,73,75,60,318,64
E0064,49,84,55,51,79,318,64
E2867,64,46,85,71,52,318,64
E9005,48,57,72,78,63,318,64
E7776,99,46,41,73,59,318,64
E3613,61,79,71,63,44,318,64
E3630,53,81,81,61,42,318,64
E4001,74,48,50,98,48,318,64
E3963,64,47,61,53,93,318,64
E0172,48,97,82,47,44,318,64
E3570,40,84,67,66,61,318,64
E9444,48,80,58,81,51,318,64
E9493,93,55,45,61,64,318,64
E5235,42,47,66,69,94,318,64
E2563,78,76,55,56,53,318,64
E2378,93,56,50,69,50,318,64
E0876,87,62,52,77,40,318,64
E0916,83,68,76,50,41,318,64
E5597,67,48,62,64,77,318,64
E5289,98,59,41,74,46,318,64
E8122,58,71,58,85,46,318,64
E8548,50,76,57,42,93,318,64
E3419,54,79,59,71,55,318,64
E5308,41,68,82,66,60,317,64
E2509,52,83,53,81,48,317,64
E7314,65,75,88,47,42,317,64
E4056,52,63,62,94,46,317,64
E5147,71,92,45,41,68,317,64
E4932,85,66,48,76,42,317,64
E7625,44,46,68,97,62,317,64
E5566,81,65,53,62,56,317,64
E8226,69,64,75,48,61,317,64
E6659,50,91,52,43,81,317,64
E0341,73,61,79,54,50,317,64
E8226,44,80,68,70,55,317,64
E7508,64,74,64,51,64,317,64
E1961,49,92,40,81,55,317,64
E1676,69,42,55,79,72,317,64
E3974,84,57,50,74,52,317,64
E4339,41,99,42,55,80,317,64
E6626,40,53,59,96,69,317,64
E9257,77,42,57,69,72,317,64
E1790,62,69,53,41,92,317,64
E3355,73,56,82,49,57,317,64
E3794,77,65,46,42,87,317,64
E6869,64,50,81,80,42,317,64
E0275,53,65,62,40,97,317,64
E0437,50,47,41,87,92,317,64
E7015,41,75,43,83,75,317,64
E9300,48,58,66,62,83,317,64
E2595,56,73,82,56,50,317,64
E6083,76,77,49,44,71,317,64
E6291,85,65,55,59,53,317,64
E2880,52,59,60,89,57,317,64
E1596,76,64,55,63,59,317,64
E3486,43,84,86,57,47,317,64
E1606,98,63,51,53,51,316,64
E6481,57,50,83,46,80,316,64
E6633,62,55,59,59,81,316,64
E6559,55,84,75,44,58,316,64
E7221,89,42,55,42,88,316,64
E7512,93,46,47,66,64,316,64
E4533,45,73,45,59,94,316,64
E5596,41,65,77,49,84,316,64
E2773,91,55,49,66,55,316,64
E7343,85,66,77,42,46,316,64
E5825,56,41,43,93,83,316,64
E7403,44,81,53,90,48,316,64
E8470,45,62,77,83,49,316,64
E1347,70,71,45,88,42,316,64
E8637,61,41,61,76,77,316,64
E3006,58,49,52,81,76,316,64
E6555,56,69,70,62,59,316,64
E5544,95,46,73,41,61,316,64
E9995,63,68,75,47,63,316,64
E7907,46,100,50,58,62,316,64
E5268,89,59,45,66,57,316,64
E5568,82,59,56,40,79,316,64
E0653,60,60,48,64,84,316,64
E1614,81,40,70,80,45,316,64
E7170,54,91,55,62,54,316,64
E5187,61,91,58,47,59,316,64
E2974,58,87,42,63,66,316,64
E4623,72,41,94,57,52,316,64
E6462,88,40,65,64,59,316,64
E2372,60,83,84,45,44,316,64
E5475,64,72,47,72,61,316,64
E6945,77,42,99,55,43,316,64
E8809,44,52,98,53,69,316,64
E7078,83,49,51,48,85,316,64
E6281,62,67,62,79,46,316,64
E7317,63,74,49,74,55,315,63
E0052,55,51,93,66,50,315,63
E7263,41,77,81,41,75,315,63
E1163,40,76,62,82,55,315,63
E8767,49,81,48,97,40,315,63
E3847,62,96,49,52,56,315,63
E9062,49,42,78,96,50,315,63
E7476,83,47,44,67,74,315,63
E8251,62,70,84,40,59,315,63
E9916,70,65,56,42,82,315,63
E5226,57,57,62,81,58,315,63
E6354,87,42,53,57,76,315,63
E7509,83,79,41,50,62,315,63
E2252,43,79,45,76,72,315,63
E7809,65,46,42,68,94,315,63
E9078,74,54,53,45,89,315,63
E4474,50,41,75,72,77,315,63
E5792,47,86,72,69,41,315,63
E0178,69,53,80,46,67,315,63
E7642,72,49,87,63,44,315,63
E2211,60,96,50,67,42,315,63
E1420,75,44,52,45,99,315,63
E4105,52,68,49,100,46,315,63
E8384,85,62,51,68,49,315,63
E0452,57,89,47,44,78,315,63
E7276,65,98,43,58,51,315,63
E7228,42,61,58,88,66,315,63
E1003,75,40,84,75,41,315,63
E1434,57,41,96,54,67,315,63
E8428,63,73,90,49,40,315,63
E4807,88,79,40,49,59,315,63
E8336,71,97,54,44,48,314,63
E2480,90,42,44,84,54,314,63
E2826,41,60,40,92,81,314,63
E3501,88,57,46,65,58,314,63
E3891,42,43,40,99,90,314,63
E7092,69,97,41,52,55,314,63
E7393,100,42,68,54,50,314,63
E4800,52,47,71,93,51,314,63
E1856,58,79,64,57,56,314,63
E9111,52,57,53,94,58,314,63
E8925,41,59,84,41,89,314,63
E3610,57,72,89,42,54,314,63
E1599,58,66,44,75,71,314,63
E6973,57,78,41,95,43,314,63
E7952,55,67,67,57,68,314,63
E5572,71,75,47,48,73,314,63
E6332,41,92,74,66,41,314,63
E4667,47,77,79,62,49,314,63
E2862,60,61,72,71,50,314,63
E3641,83,81,53,52,45,314,63
E6186,60,46,74,86,48,314,63
E2399,99,55,40,78,42,314,63
E3323,80,52,42,71,69,314,63
E8119,90,43,40,68,73,314,63
E4894,53,50,75,67,69,314,63
E2729,41,74,87,50,62,314,63
E1679,59,65,87,50,53,314,63
E6454,80,72,54,41,67,314,63
E1866,62,67,75,43,67,314,63
E9421,44,100,44,76,50,314,63
E7588,45,89,97,41,42,314,63
E6728,61,46,79,59,69,314,63
E8715,52,50,40,79,93,314,63
E3413,54,98,53,44,65,314,63
E9568,42,99,63,45,65,314,63
E4865,54,75,44,62,79,314,63
E0913,67,86,70,49,42,314,63
E2732,51,97,61,54,51,314,63
E1457,66,45,85,46,72,314,63
E0272,51,86,68,61,48,314,63
E8577,55,53,54,87,65,314,63
E8339,41,79,58,92,44,314,63
E0830,51,47,88,49,78,313,63
E9622,58,88,70,56,41,313,63
E5224,41,66,42,68,96,313,63
E4478,73,70,50,72,48,313,63
E1765,50,71,46,57,89,313,63
E5701,48,83,54,40,88,313,63
E0483,44,65,74,64,66,313,63
E3585,55,46,71,82,59,313,63
E2040,45,73,93,61,41,313,63
E8021,91,50,56,68,48,313,63
E6813,77,90,52,53,41,313,63
E5300,51,53,83,53,73,313,63
E4198,55,46,95,68,49,313,63
E4791,84,65,48,50,66,313,63
E5762,44,67,50,73,79,313,63
E4994,60,50,86,41,76,313,63
E6412,55,48,81,74,55,313,63
E8493,68,73,63,63,46,313,63
E5583,45,78,79,47,64,313,63
E2662,70,50,44,82,67,313,63
E9389,52,75,95,43,48,313,63
E7202,56,66,52,81,58,313,63
E5800,54,82,65,70,42,313,63
E3090,57,96,52,52,56,313,63
E5403,44,56,60,93,60,313,63
E8630,72,64,57,52,68,313,63
E8733,44,82,41,81,65,313,63
E7645,48,95,48,74,48,313,63
E9790,70,51,93,42,57,313,63
E3454,81,90,54,43,45,313,63
E5062,87,58,56,63,49,313,63
E2035,83,48,41,75,66,313,63
E7162,49,61,40,74,89,313,63
E4335,99,52,51,42,69,313,63
E3279,44,52,100,62,55,313,63
E7141,76,50,64,50,73,313,63
E4261,42,40,98,72,61,313,63
E4798,42,53,44,97,77,313,63
E5534,93,52,41,71,56,313,63
E7528,45,91,68,66,43,313,63
E4788,61,47,55,100,50,313,63
E8988,62,43,94,71,43,313,63
E8933,42,88,54,54,75,313,63
E7451,92,53,76,43,49,313,63
E5476,61,68,46,76,62,313,63
E8993,43,60,43,91,75,312,63
E9538,78,46,88,43,57,312,63
E8151,90,44,89,45,44,312,63
E9736,66,60,67,73,46,312,63
E7791,43,66,70,57,76,312,63
E4181,59,55,42,86,70,312,63
E3992,80,40,83,58,51,312,63
E7288,47,96,77,50,42,312,63
E5075,82,52,83,46,49,312,63
E0926,60,67,50,86,49,312,63
E0794,44,42,85,88,53,312,63
E1444,90,79,48,46,49,312,63
E3372,48,50,79,74,61,312,63
E7334,46,45,83,63,75,312,63
E4491,75,79,56,46,56,312,63
E6095,81,80,41,57,53,312,63
E4726,52,85,70,51,54,312,63
E7405,46,46,75,58,87,312,63
E4934,42,77,49,86,58,312,63
E2643,50,79,58,45,80,312,63
E7391,57,75,51,43,86,312,63
E8567,97,40,68,45,62,312,63
E0293,57,93,63,57,42,312,63
E6579,82,85,42,56,47,312,63
E2046,61,79,60,64,48,312,63
E7064,62,52,76,68,53,311,63
E4173,86,40,50,64,71,311,63
E2775,79,61,50,58,63,311,63
E2173,48,63,75,82,43,311,63
E0314,81,47,68,56,59,311,63
E7370,52,95,46,59,59,311,63
E6342,49,55,46,92,69,311,63
E9693,43,82,68,61,57,311,63
E2023,65,58,62,72,54,311,63
E1832,62,83,45,40,81,311,63
E4306,61,52,46,60,92,311,63
E4730,45,89,55,56,66,311,63
E0570,58,84,54,64,51,311,63
E2512,65,60,51,62,73,311,63
E1366,73,40,64,59,75,311,63
E6851,54,44,49,67,97,311,63
E0909,47,59,62,60,83,311,63
E4498,58,43,78,71,61,311,63
E7767,41,57,96,64,53,311,63
E2091,72,60,62,68,49,311,63
E0765,72,100,40,59,40,311,63
E2631,57,98,42,46,68,311,63
E2638,71,73,42,64,61,311,63
E5765,84,45,53,55,74,311,63
E3466,45,48,69,76,73,311,63
E6960,57,40,92,57,64,310,62
E6000,56,97,64,51,42,310,62
E2107,88,74,45,62,41,310,62
E2617,43,78,69,48,72,310,62
E5701,51,65,53,48,93,310,62
E0625,60,71,47,44,88,310,62
E8261,76,56,43,65,70,310,62
E5718,57,43,54,84,72,310,62
E0206,90,41,73,48,58,310,62
E2159,57,92,64,42,55,310,62
E3728,51,96,43,69,51,310,62
E6655,43,56,88,72,51,310,62
E3517,62,54,41,65,88,310,62
E6000,72,47,44,81,66,310,62
E2719,41,69,50,60,90,310,62
E0569,46,75,73,64,52,310,62
E3344,51,65,51,87,56,310,62
E2604,40,41,67,66,96,310,62
E4355,55,71,43,94,47,310,62
E0318,80,45,86,56,43,310,62
E0273,62,43,80,58,67,310,62
E6213,57,73,97,43,40,310,62
E9078,62,47,61,49,91,310,62
E2776,84,59,49,65,53,310,62
E2779,80,59,48,72,51,310,62
E3337,67,59,74,52,58,310,62
E2758,70,42,74,60,64,310,62
E2496,56,55,74,49,76,310,62
E3823,63,69,49,71,58,310,62
E5812,41,74,70,64,60,309,62
E7666,92,59,40,51,67,309,62
E8477,75,49,61,40,84,309,62
E9542,40,49,82,46,92,309,62
E9868,73,64,43,77,52,309,62
E3037,82,45,69,58,55,309,62
E3128,62,69,55,69,54,309,62
E1475,58,93,53,61,44,309,62
E7656,43,48,96,63,59,309,62
E4251,62,56,59,40,92,309,62
E4009,50,43,70,53,93,309,62
E1729,50,50,61,53,95,309,62
E1187,94,66,45,46,58,309,62
E3955,76,77,51,45,60,309,62
E7810,65,45,45,84,70,309,62
E5171,45,77,82,63,42,309,62
E5230,80,43,83,58,45,309,62
E6694,50,96,45,55,63,309,62
E5079,54,72,68,64,51,309,62
E0787,41,59,73,58,78,309,62
E7454,100,42,40,50,77,309,62
E7311,84,60,58,42,65,309,62
E4535,82,47,77,63,40,309,62
E6069,51,43,75,52,88,309,62
E1908,71,66,41,84,47,309,62
E9142,56,42,68,98,45,309,62
E4441,40,86,56,85,42,309,62
E7358,49,88,52,42,78,309,62
E4039,80,71,71,43,44,309,62
E3547,43,63,81,81,41,309,62
E8872,73,50,74,55,57,309,62
E3344,45,46,72,53,93,309,62
E3808,72,73,51,71,42,309,62
E6099,44,90,48,68,59,309,62
E1616,76,71,65,57,40,309,62
E8999,64,67,44,63,70,308,62
E5673,82,54,50,43,79,308,62
E6443,70,48,77,53,60,308,62
E2393,61,54,97,40,56,308,62
E3307,72,60,65,48,63,308,62
E7170,67,70,41,74,56,308,62
E4117,71,41,66,56,74,308,62
E8639,58,76,54,69,51,308,62
E9260,52,41,42,80,93,308,62
E0676,68,46,81,54,59,308,62
E5761,69,62,43,59,75,308,62
E9560,74,53,49,60,72,308,62
E5381,52,42,83,43,88,308,62
E0190,96,56,58,41,57,308,62
E7677,46,81,52,56,73,308,62
E6895,50,62,70,66,60,308,62
E2716,44,82,40,93,49,308,62
E6574,100,42,60,45,61,308,62
E8762,49,72,53,82,52,308,62
E9212,63,61,85,56,43,308,62
E5846,66,69,41,72,60,308,62
E1675,65,41,64,57,81,308,62
E0038,58,90,73,40,47,308,62
E7591,60,42,54,100,52,308,62
E5487,40,81,93,43,51,308,62
E4383,77,74,49,54,54,308,62
E9572,72,41,46,60,89,308,62
E9463,74,47,83,45,59,308,62
E0717,80,50,51,44,83,308,62
E7649,44,55,78,47,84,308,62
E7454,47,63,70,79,48,307,62
E9248,40,51,51,70,95,307,62
E2211,66,43,51,65,82,307,62
E2956,47,68,65,86,41,307,62
E1616,71,70,49,63,54,307,62
E2811,41,99,63,49,55,307,62
E9414,64,57,55,58,73,307,62
E6385,42,64,49,98,54,307,62
E5454,52,69,47,57,82,307,62
E4871,81,43,61,74,48,307,62
E8131,86,43,74,55,49,307,62
E1961,62,74,53,60,58,307,62
E5412,41,85,41,96,44,307,62
E8166,43,40,76,73,75,307,62
E6437,83,46,76,49,53,307,62
E2827,57,93,58,56,43,307,62
E2677,71,69,81,44,42,307,62
E8745,95,61,50,40,61,307,62
E7339,50,71,73,56,57,307,62
E2749,51,56,53,97,50,307,62
E9639,48,51,45,92,71,307,62
E1067,82,62,56,67,40,307,62
E4710,66,64,62,72,43,307,62
E8494,53,64,50,86,54,307,62
E4193,41,50,67,51,98,307,62
E0983,47,87,42,62,69,307,62
E3942,45,49,77,69,67,307,62
E2544,65,55,75,44,67,306,62
E5363,52,53,41,97,63,306,62
E3254,42,59,57,93,55,306,62
E7929,43,51,98,65,49,306,62
E6108,55,47,85,50,69,306,62
E6689,56,50,94,65,41,306,62
E2483,70,55,55,45,81,306,62
E0820,40,40,64,89,73,306,62
E6774,66,82,40,74,44,306,62
E6346,91,43,46,48,78,306,62
E8219,75,65,47,62,57,306,62
E9767,78,49,53,82,44,306,62
E8498,44,61,53,64,84,306,62
E5864,86,57,43,68,52,306,62
E7441,56,93,41,70,46,306,62
E3395,70,40,58,72,66,306,62
E3195,46,49,88,58,65,306,62
E1194,45,42,77,82,60,306,62
E0706,70,46,57,51,82,306,62
E7596,52,44,92,61,57,306,62
E8433,86,53,52,41,74,306,62
E2728,88,70,46,44,58,306,62
E2097,72,53,79,59,43,306,62
E7617,91,66,40,45,64,306,62
E0427,84,58,51,70,43,306,62
E2388,66,43,69,63,65,306,62
E7333,69,66,64,55,52,306,62
E6460,45,42,73,92,54,306,62
E1217,48,56,59,52,90,305,61
E0182,72,40,85,48,60,305,61
E4110,77,54,42,59,73,305,61
E8586,44,43,62,62,94,305,61
E8873,41,61,77,55,71,305,61
E4247,44,43,95,57,66,305,61
E7035,75,44,81,57,48,305,61
E8610,47,98,63,56,41,305,61
E3302,82,57,68,46,52,305,61
E4657,48,55,55,93,54,305,61
E7588,81,47,92,42,43,305,61
E9288,94,40,45,62,64,305,61
E2189,46,40,70,86,63,305,61
E5190,42,43,41,90,89,305,61
E3604,67,44,73,69,52,305,61
E2664,47,79,83,46,50,305,61
E3718,81,55,67,42,60,305,61
E8372,45,97,69,47,47,305,61
E0380,89,40,55,46,75,305,61
E1183,79,41,51,82,52,305,61
E4424,63,87,44,53,58,305,61
E4752,93,57,69,43,43,305,61
E5600,82,77,50,45,51,305,61
E9861,42,84,66,49,64,305,61
E9697,93,46,68,52,45,304,61
E2944,53,66,81,44,60,304,61
E9475,52,68,47,77,60,304,61
E1857,84,60,54,47,59,304,61
E7290,63,59,54,55,73,304,61
E4617,49,68,76,48,63,304,61
E0232,48,76,49,86,45,304,61
E9377,86,48,46,64,60,304,61
E7335,63,78,54,60,49,304,61
E6269,63,81,46,42,72,304,61
E2168,81,70,54,53,46,304,61
E3518,60,51,52,100,41,304,61
E1062,40,80,62,78,44,304,61
E2929,59,71,64,46,64,304,61
E7093,77,67,63,54,43,304,61
E7408,85,44,79,56,40,304,61
E6363,60,54,74,72,44,304,61
E2973,48,71,76,49,60,304,61
E8830,44,68,68,73,51,304,61
E0565,66,64,55,71,48,304,61
E3181,43,69,88,56,48,304,61
E2245,73,61,56,64,50,304,61
E8674,42,43,46,88,84,303,61
E1269,74,45,41,93,50,303,61
E5978,41,41,82,92,47,303,61
E9483,52,44,58,93,56,303,61
E9374,96,49,44,56,58,303,61
E4932,89,64,52,43,55,303,61
E5780,49,41,59,89,65,303,61
E4642,58,73,52,44,76,303,61
E1108,77,56,40,90,40,303,61
E8644,59,64,70,47,63,303,61
E1125,50,45,77,52,79,303,61
E9181,93,43,66,55,46,303,61
E8685,46,78,69,41,69,303,61
E3400,46,61,64,73,59,303,61
E6578,46,62,88,62,45,303,61
E8582,54,82,49,69,49,303,61
E1201,52,40,91,58,62,303,61
E0194,59,93,46,64,41,303,61
E5923,73,64,40,41,85,303,61
E4002,61,41,64,72,65,303,61
E5776,41,48,64,65,85,303,61
E6239,66,85,57,43,52,303,61
E5032,70,62,41,49,81,303,61
E1805,70,54,71,48,59,302,61
E1551,52,57,53,40,100,302,61
E1746,90,47,61,50,54,302,61
E5445,66,68,40,58,70,302,61
E0454,49,58,93,42,60,302,61
E2057,52,88,59,50,53,302,61
E2109,56,64,70,52,60,302,61
E7619,50,73,80,44,55,302,61
E8877,58,53,50,77,64,302,61
E9090,66,65,57,48,66,302,61
E9154,51,54,69,64,64,302,61
E3600,43,81,80,53,45,302,61
E7210,57,80,44,43,78,302,61
E1177,48,75,45,64,70,302,61
E3603,55,58,72,70,47,302,61
E7380,58,50,58,46,90,302,61
E8021,65,45,66,79,47,302,61
E9407,92,57,43,55,55,302,61
E4312,43,55,67,92,45,302,61
E4700,68,67,70,40,57,302,61
E0946,42,71,52,95,42,302,61
E0464,54,55,72,67,54,302,61
E7569,61,69,46,47,79,302,61
E6661,53,79,40,44,86,302,61
E8801,66,49,43,56,88,302,61
E2613,72,62,44,61,63,302,61
E5226,54,57,86,52,53,302,61
E2720,54,50,71,43,84,302,61
E1208,93,41,55,60,53,302,61
E5793,48,70,69,60,54,301,61
E1128,40,53,78,80,50,301,61
E8294,52,48,86,53,62,301,61
E7114,45,44,72,99,41,301,61
E3857,64,77,61,56,43,301,61
E8291,62,66,50,77,46,301,61
E0721,71,72,59,51,48,301,61
E3504,52,55,67,82,45,301,61
E6870,57,59,43,75,67,301,61
E7151,65,65,51,52,68,301,61
E4032,60,49,59,53,80,301,61
E0689,47,46,67,80,61,301,61
E5631,41,50,51,89,70,301,61
E5937,54,47,95,42,63,301,61
E6895,66,47,42,70,76,301,61
E7146,53,99,50,45,54,301,61
E8931,76,49,75,51,50,301,61
E4839,56,45,59,89,52,301,61
E0649,64,47,64,48,78,301,61
E7462,58,54,45,71,73,301,61
E1978,42,84,45,85,45,301,61
E3160,46,83,54,74,44,301,61
E0829,52,62,67,72,48,301,61
E3895,47,40,50,63,100,300,60
E2661,62,78,51,43,66,300,60
E0297,45,76,72,44,63,300,60
E4122,69,57,50,40,84,300,60
E7976,41,40,66,96,57,300,60
E2553,47,100,48,60,45,300,60
E2442,59,73,50,61,57,300,60
E8645,49,47,46,81,77,300,60
E5861,45,90,61,62,42,300,60
E1055,65,42,66,73,54,300,60
E7108,42,99,47,53,59,300,60
E8027,99,60,51,40,50,300,60
E5571,66,48,60,43,83,300,60
E3295,46,89,45,45,75,300,60
E0296,64,65,75,45,51,300,60
E4204,91,47,60,52,50,300,60
E6809,49,46,51,100,54,300,60
E7534,50,74,45,58,73,300,60
E8147,65,52,41,96,46,300,60
E1354,44,58,70,79,49,300,60
E3988,57,46,89,44,64,300,60
E0304,44,89,58,49,60,300,60
E4570,82,49,60,63,46,300,60
E3357,61,62,52,48,77,300,60
E3523,61,40,76,60,63,300,60
E2664,54,87,60,42,57,300,60
E9508,45,67,56,80,52,300,60
E0754,70,60,46,71,53,300,60
E7464,72,53,68,60,47,300,60
E9521,62,86,49,49,54,300,60
E4896,75,49,89,43,44,300,60
E0558,75,91,46,44,43,299,60
E2550,48,96,46,49,60,299,60
E9688,67,64,81,43,44,299,60
E6956,85,43,67,40,64,299,60
E7154,48,54,54,91,52,299,60
E3395,63,58,40,76,62,299,60
E5603,45,100,44,70,40,299,60
E8509,42,84,64,43,66,299,60
E5067,51,48,89,57,54,299,60
E0714,76,75,53,54,41,299,60
E5898,53,44,84,68,50,299,60
E2815,53,48,47,81,70,299,60
E8091,43,50,55,90,61,299,60
E2211,89,44,67,51,48,299,60
E0986,59,73,57,69,41,299,60
E3621,77,61,48,55,58,299,60
E5934,83,67,50,57,42,299,60
E0355,66,46,57,79,51,299,60
E0568,55,98,43,61,42,299,60
E3426,50,40,44,73,92,299,60
E2169,53,53,59,62,72,299,60
E3452,97,45,40,66,51,299,60
E8045,55,89,45,49,61,299,60
E4777,76,56,83,42,42,299,60
E3536,40,58,63,92,46,299,60
E8547,73,72,49,54,50,298,60
E9632,43,67,49,91,48,298,60
E9370,100,54,41,59,44,298,60
E0501,47,66,56,51,78,298,60
E4596,72,59,74,45,48,298,60
E4697,50,54,49,58,87,298,60
E5503,57,97,41,61,42,298,60
E5261,50,57,76,66,49,298,60
E1568,41,75,80,43,59,298,60
E4606,90,46,57,41,64,298,60
E7068,47,57,93,53,48,298,60
E3985,48,89,48,61,52,298,60
E2852,100,48,45,50,55,298,60
E2041,61,46,57,79,55,298,60
E4693,62,59,69,40,68,298,60
E3723,42,60,54,91,51,298,60
E7007,60,64,49,76,49,298,60
E6804,41,71,73,67,46,298,60
E4991,47,44,82,73,52,298,60
E8508,64,45,41,82,66,298,60
E2446,60,49,54,45,90,298,60
E1745,78,52,41,42,85,298,60
E5343,84,55,40,65,54,298,60
E8346,57,46,73,63,59,298,60
E2400,74,59,60,59,46,298,60
E2692,43,92,59,41,63,298,60
E6529,44,75,41,91,47,298,60
E5332,56,58,82,57,44,297,60
E3761,52,48,49,63,85,297,60
E2668,52,95,54,53,43,297,60
E5082,63,41,70,41,82,297,60
E4294,53,75,43,71,55,297,60
E1826,54,65,56,77,45,297,60
E7841,62,58,44,44,89,297,60
E0711,41,64,71,46,75,297,60
E1592,93,41,65,48,50,297,60
E9161,70,77,52,50,48,297,60
E9798,77,63,63,52,42,297,60
E5568,45,43,69,72,68,297,60
E7325,40,64,45,67,81,297,60
E7549,40,63,61,68,65,297,60
E5518,73,49,46,57,72,297,60
E9633,61,57,47,78,54,297,60
E3937,78,64,66,49,40,297,60
E6525,56,72,61,55,53,297,60
E8328,76,59,41,63,58,297,60
E9337,65,79,46,53,54,297,60
E5152,45,47,60,54,91,297,60
E7680,42,67,78,46,64,297,60
E1087,56,99,42,59,41,297,60
E9956,44,44,95,67,46,296,60
E2417,46,54,57,55,84,296,60
E6812,54,61,55,85,41,296,60
E0956,40,48,55,58,95,296,60
E5695,52,58,51,52,83,296,60
E4840,69,45,86,53,43,296,60
E7670,68,48,95,40,45,296,60
E5828,57,45,43,72,79,296,60
E9578,41,50,47,97,61,296,60
E4036,54,70,70,61,41,296,60
E7529,70,45,79,49,53,296,60
E4609,79,48,49,53,67,296,60
E0212,48,99,43,46,60,296,60
E8611,53,56,51,83,53,296,60
E2496,56,52,56,62,70,296,60
E1948,54,48,42,100,52,296,60
E3642,41,43,46,89,77,296,60
E4271,47,50,85,40,74,296,60
E5098,63,67,71,55,40,296,60
E6600,53,45,51,69,78,296,60
E0021,48,49,47,100,52,296,60
E9062,70,52,65,56,53,296,60
E5100,66,47,44,50,89,296,60
E6035,81,79,47,42,47,296,60
E0589,47,84,51,53,61,296,60
E9590,49,45,75,71,56,296,60
E6004,76,90,44,45,41,296,60
E4250,75,58,49,63,51,296,60
E6390,86,41,45,41,82,295,59
E3521,40,72,43,58,82,295,59
E9182,75,74,59,41,46,295,59
E4764,47,93,42,40,73,295,59
E6088,66,60,67,47,55,295,59
E5554,91,51,68,45,40,295,59
E6568,51,72,64,50,58,295,59
E8363,44,59,92,57,43,295,59
E5167,47,51,80,60,57,295,59
E8852,42,61,89,40,63,295,59
E8346,70,42,51,59,73,295,59
E6358,86,44,57,40,68,295,59
E1890,69,52,46,48,80,295,59
E9685,64,54,66,42,69,295,59
E1075,41,91,59,54,50,295,59
E6113,63,47,49,40,96,295,59
E0200,99,43,52,48,53,295,59
E8992,61,68,53,43,70,295,59
E2242,40,93,66,55,41,295,59
E0585,60,56,43,56,80,295,59
E3545,70,48,53,70,53,294,59
E3286,50,42,61,46,95,294,59
E5506,43,53,78,80,40,294,59
E1011,86,51,62,43,52,294,59
E7627,62,64,63,51,54,294,59
E2284,69,46,44,41,94,294,59
E6532,42,53,94,59,46,294,59
E9240,93,53,57,51,40,294,59
E4104,46,79,46,66,57,294,59
E5164,51,57,57,71,58,294,59
E4886,45,66,50,64,69,294,59
E0795,52,69,51,49,73,294,59
E6474,40,73,58,48,75,294,59
E2684,62,53,52,64,63,294,59
E5396,76,42,59,40,77,294,59
E1389,44,50,42,60,98,294,59
E4656,43,95,42,42,72,294,59
E2360,56,49,58,55,76,294,59
E7292,83,69,41,55,46,294,59
E9640,76,79,49,40,50,294,59
E3313,54,42,62,92,43,293,59
E3165,48,72,46,61,66,293,59
E8550,42,80,65,55,51,293,59
E0065,58,88,46,54,47,293,59
E6129,73,69,50,41,60,293,59
E2479,75,56,65,51,46,293,59
E0162,66,51,94,42,40,293,59
E7230,54,47,69,58,65,293,59
E6807,53,45,86,67,42,293,59
E9944,40,54,48,75,76,293,59
E3135,65,45,49,86,48,293,59
E7723,65,58,70,49,51,293,59
E0442,48,58,47,63,77,293,59
E1226,46,58,92,53,44,293,59
E6833,97,49,46,44,57,293,59
E8608,56,70,74,46,47,293,59
E7997,42,81,51,53,66,293,59
E6988,73,51,58,44,67,293,59
E0558,79,70,44,52,48,293,59
E8597,60,48,59,58,68,293,59
E8203,51,51,53,46,91,292,59
E4478,91,41,48,72,40,292,59
E1745,72,63,46,52,59,292,59
E5896,49,70,43,52,78,292,59
E2528,52,48,76,52,64,292,59
E2621,52,68,40,57,75,292,59
E8987,51,59,72,50,60,292,59
E0772,50,63,49,60,70,292,59
E2741,48,98,42,43,61,292,59
E5257,54,42,62,87,47,292,59
E9486,77,58,50,51,56,292,59
E8322,42,61,86,56,47,292,59
E5143,45,41,59,76,71,292,59
E2017,96,61,40,43,52,292,59
E6811,47,47,47,99,52,292,59
E7817,75,47,42,76,52,292,59
E8598,62,58,43,52,77,292,59
E3688,70,41,72,41,68,292,59
E7935,62,70,48,42,70,292,59
E3659,69,72,49,46,56,292,59
E8868,49,74,51,41,77,292,59
E3746,48,48,100,56,40,292,59
E9606,76,62,42,41,70,291,59
E5924,46,43,47,62,93,291,59
E5436,76,49,46,42,78,291,59
E4522,54,72,68,53,44,291,59
E0194,47,45,51,48,100,291,59
E1092,57,41,67,52,74,291,59
E1817,72,60,61,43,55,291,59
E3181,63,52,45,79,52,291,59
E3625,43,55,69,84,40,291,59
E9243,57,57,45,76,56,291,59
E8057,56,82,56,53,44,291,59
E5181,92,51,62,43,43,291,59
E2551,44,77,65,40,65,291,59
E3853,68,76,45,49,53,291,59
E7734,45,40,67,44,95,291,59
E3114,60,56,49,86,40,291,59
E8798,57,47,57,70,60,291,59
E6720,61,44,42,95,49,291,59
E9145,80,66,45,60,40,291,59
E4941,75,60,59,50,46,290,58
E6655,75,48,58,42,67,290,58
E5176,58,47,49,94,42,290,58
E7446,46,40,94,61,49,290,58
E9850,48,68,82,50,42,290,58
E3690,47,55,54,84,50,290,58
E9273,44,63,48,57,78,290,58
E2486,52,69,78,48,43,290,58
E8271,67,58,53,40,72,290,58
E3762,69,50,50,45,76,290,58
E2805,42,58,97,40,53,290,58
E5036,83,48,56,40,63,290,58
E8008,61,98,42,40,49,290,58
E4268,87,72,40,46,45,290,58
E0578,62,64,48,51,65,290,58
E5546,75,50,58,67,40,290,58
E9226,53,63,65,63,45,289,58
E6726,67,83,43,55,41,289,58
E1931,53,81,48,65,42,289,58
E7690,47,68,57,45,72,289,58
E3713,87,64,41,54,43,289,58
E7976,78,53,56,53,49,289,58
E0545,54,53,76,48,58,289,58
E7425,41,69,63,68,48,289,58
E1905,51,58,52,44,84,289,58
E6281,76,48,45,76,44,289,58
E2339,79,62,41,53,54,289,58
E5211,60,42,77,44,66,289,58
E4919,64,57,70,53,45,289,58
E3493,61,70,46,60,52,289,58
E0412,51,69,74,48,47,289,58
E4801,48,48,63,76,54,289,58
E9359,69,43,61,73,43,289,58
E7613,49,45,78,74,43,289,58
E0452,80,46,68,46,49,289,58
E9064,50,48,56,56,79,289,58
E9383,60,80,46,47,56,289,58
E1603,44,60,43,48,94,289,58
E6834,60,44,44,45,96,289,58
E5772,42,69,73,46,59,289,58
E9948,44,52,78,50,64,288,58
E0222,71,43,82,48,44,288,58
E8214,41,46,51,51,99,288,58
E3278,43,71,59,59,56,288,58
E9302,63,50,72,63,40,288,58
E1240,82,40,61,43,62,288,58
E9544,42,40,64,73,69,288,58
E7363,74,47,59,59,49,288,58
E1882,59,52,57,77,43,288,58
E2533,45,68,44,64,67,288,58
E8961,81,51,47,60,49,288,58
E9135,55,57,73,42,61,288,58
E2790,52,56,84,41,55,288,58
E6076,65,82,52,40,49,288,58
E1386,61,59,77,49,42,288,58
E6206,47,49,81,54,57,288,58
E0816,48,85,49,65,41,288,58
E6952,49,57,41,96,44,287,58
E4742,47,67,48,74,51,287,58
E2954,42,55,51,66,73,287,58
E6970,54,74,44,49,66,287,58
E0665,45,72,40,44,86,287,58
E9175,88,70,41,47,41,287,58
E9093,49,54,87,43,54,287,58
E2667,57,66,62,48,54,287,58
E4410,60,42,41,80,64,287,58
E6861,65,49,46,54,73,287,58
E1366,60,55,56,66,50,287,58
E2043,57,56,56,67,51,287,58
E7648,45,44,43,94,61,287,58
E6081,51,61,58,64,53,287,58
E8898,46,66,54,61,60,287,58
E0163,65,61,51,63,46,286,58
E5966,66,42,57,46,75,286,58
E6463,44,60,48,43,91,286,58
E1003,46,81,52,54,53,286,58
E7458,78,42,50,72,44,286,58
E2682,80,69,43,50,44,286,58
E1922,48,56,47,95,40,286,58
E6890,69,41,48,85,43,286,58
E9422,52,99,41,41,53,286,58
E6292,48,94,62,42,40,286,58
E3702,50,98,40,51,47,286,58
E9900,76,60,53,53,44,286,58
E2817,74,65,47,41,59,286,58
E3494,57,71,52,42,63,285,57
E4645,59,46,72,56,52,285,57
E0296,50,41,69,51,74,285,57
E6166,85,57,58,45,40,285,57
E8379,54,57,41,90,43,285,57
E8409,62,46,59,48,70,285,57
E6326,42,54,97,42,50,285,57
E7294,68,42,66,66,43,285,57
E0203,51,45,72,44,73,285,57
E5389,55,44,43,79,64,285,57
E3390,42,67,62,58,55,284,57
E4299,54,49,55,51,75,284,57
E2670,48,59,52,41,84,284,57
E0401,71,45,55,73,40,284,57
E7647,59,55,51,53,66,284,57
E9490,78,56,45,44,61,284,57
E0264,45,42,55,79,63,284,57
E0983,63,43,63,57,58,284,57
E2205,48,58,54,44,80,284,57
E7403,56,55,76,47,50,284,57
E4318,55,50,72,63,44,284,57
E2224,63,40,42,45,94,284,57
E2603,41,69,48,73,53,284,57
E2616,41,69,89,42,43,284,57
E8515,73,47,69,51,44,284,57
E1238,44,41,56,55,88,284,57
E2441,49,64,43,60,68,284,57
E2943,42,57,100,44,41,284,57
E0585,50,58,87,48,40,283,57
E6119,49,57,64,59,54,283,57
E3404,83,46,58,54,42,283,57
E3594,68,61,62,45,47,283,57
E1261,55,41,91,46,50,283,57
E2447,48,64,70,44,57,283,57
E5457,70,49,40,72,52,283,57
E8210,48,50,54,50,81,283,57
E6547,59,40,82,57,45,283,57
E9820,63,46,85,45,44,283,57
E8533,54,99,40,50,40,283,57
E7525,57,76,40,54,56,283,57
E9381,45,64,43,72,59,283,57
E4213,58,45,40,96,43,282,57
E2104,41,74,61,57,49,282,57
E9098,41,51,62,60,68,282,57
E9002,58,59,70,54,41,282,57
E6457,50,65,77,48,42,282,57
E7349,45,84,41,64,48,282,57
E1011,49,75,54,49,55,282,57
E4131,53,62,44,41,82,282,57
E8255,51,56,80,43,52,282,57
E8452,59,41,64,73,44,281,57
E3436,52,65,48,60,56,281,57
E8213,43,73,60,50,55,281,57
E5769,58,56,82,42,43,281,57
E3104,58,59,51,50,63,281,57
E6516,62,61,57,47,54,281,57
E3274,73,64,41,48,55,281,57
E0199,48,64,42,58,69,281,57
E3120,45,42,43,91,60,281,57
E1249,93,40,51,49,48,281,57
E3225,83,46,45,55,52,281,57
E7030,77,51,40,54,59,281,57
E3629,40,50,56,93,42,281,57
E5178,53,42,62,77,46,280,56
E5134,49,54,62,60,55,280,56
E2477,43,58,61,67,51,280,56
E7653,40,69,43,42,86,280,56
E1990,41,48,53,98,40,280,56
E4454,47,68,68,57,40,280,56
E8600,43,41,42,69,85,280,56
E7529,60,58,55,62,45,280,56
E2761,43,58,62,72,45,280,56
E3103,59,49,51,66,55,280,56
E2822,76,58,42,43,60,279,56
E3699,63,50,68,40,58,279,56
E8760,69,46,60,51,53,279,56
E8754,42,92,51,40,54,279,56
E1361,48,44,49,46,92,279,56
E0443,47,54,89,43,46,279,56
E9615,60,54,40,47,77,278,56
E6507,77,48,51,54,48,278,56
E5249,60,73,41,61,43,278,56
E4962,51,50,50,45,82,278,56
E0994,50,46,41,55,86,278,56
E6215,42,42,50,63,80,277,56
E1291,41,58,47,65,66,277,56
E3244,42,43,81,66,45,277,56
E2874,53,50,47,43,84,277,56
E4111,50,45,90,42,50,277,56
E0552,57,48,57,41,74,277,56
E3963,63,41,42,80,51,277,56
E5502,44,41,67,46,79,277,56
E4872,41,74,70,52,40,277,56
E1689,73,68,46,44,46,277,56
E4485,47,49,48,72,60,276,56
E3661,52,43,49,71,61,276,56
E2908,48,73,61,43,51,276,56
E7968,51,62,42,61,60,276,56
E8026,50,61,40,72,53,276,56
E6982,47,50,63,76,40,276,56
E5797,57,43,61,45,70,276,56
E8342,49,57,83,47,40,276,56
E6043,57,45,40,51,83,276,56
E0059,69,46,43,68,49,275,55
E8577,65,59,49,43,59,275,55
E9296,73,45,50,43,64,275,55
E0515,54,59,63,42,57,275,55
E8911,46,40,63,45,81,275,55
E2241,58,42,76,47,52,275,55
E7961,43,55,46,58,73,275,55
E3048,56,61,43,65,50,275,55
E0781,77,43,41,51,63,275,55
E2059,70,50,50,51,54,275,55
E2271,64,53,48,69,41,275,55
E8790,45,42,50,49,88,274,55
E3661,43,41,59,85,46,274,55
E8207,43,68,46,62,55,274,55
E3444,50,41,64,49,70,274,55
E6571,55,77,46,40,56,274,55
E1506,51,52,89,40,42,274,55
E6138,51,54,71,56,42,274,55
E0183,53,44,67,42,67,273,55
E3932,48,52,55,43,75,273,55
E9156,40,53,44,78,58,273,55
E7330,49,48,53,56,67,273,55
E8769,90,47,42,45,49,273,55
E0512,63,50,67,42,51,273,55
E6875,43,48,52,70,59,272,55
E8122,42,63,61,48,58,272,55
E8873,53,57,53,53,56,272,55
E0688,60,54,42,48,68,272,55
E9082,84,40,49,53,46,272,55
E8699,61,46,50,60,55,272,55
E4531,53,42,40,86,51,272,55
E7215,64,75,45,40,48,272,55
E9755,89,44,49,48,41,271,55
E8607,43,67,45,71,45,271,55
E6535,47,47,77,46,54,271,55
E1998,68,52,58,49,44,271,55
E0094,50,60,58,42,61,271,55
E1200,48,46,74,58,45,271,55
E4224,42,43,86,55,44,270,54
E9899,41,60,51,58,60,270,54
E7598,47,46,60,69,48,270,54
E6947,66,42,41,53,68,270,54
E1111,50,49,41,77,53,270,54
E1916,54,48,50,60,58,270,54
E5257,70,45,40,58,56,269,54
E4822,51,45,49,61,63,269,54
E3060,55,46,60,61,47,269,54
E6322,59,52,69,46,43,269,54
E9471,53,79,52,45,40,269,54
E8574,42,42,41,73,70,268,54
E0233,48,47,57,70,45,267,54
E5046,47,59,57,64,40,267,54
E7068,50,74,45,55,43,267,54
E6778,61,64,58,44,40,267,54
E9903,48,83,53,41,42,267,54
E0874,55,51,41,78,42,267,54
E3815,50,51,40,79,47,267,54
E8189,43,76,42,48,58,267,54
E7263,52,40,54,56,65,267,54
E1933,59,47,50,66,45,267,54
E5058,67,42,44,44,70,267,54
E3897,62,58,42,44,61,267,54
E0921,42,54,64,48,59,267,54
E7855,56,44,54,71,41,266,54
E9651,82,47,51,45,41,266,54
E1004,57,40,61,57,51,266,54
E8032,72,40,47,47,60,266,54
E5016,49,68,45,43,61,266,54
E3127,57,68,49,41,51,266,54
E9759,72,46,45,61,42,266,54
E6182,58,53,62,48,45,266,54
E5711,51,75,50,48,41,265,53
E0657,62,49,46,53,55,265,53
E1715,43,49,44,57,72,265,53
E6846,41,75,44,52,52,264,53
E4396,53,56,43,51,61,264,53
E3148,42,52,43,48,79,264,53
E7301,50,64,46,47,57,264,53
E8623,43,80,44,48,49,264,53
E6724,51,46,61,50,56,264,53
E5854,69,49,57,49,40,264,53
E2736,72,51,52,45,43,263,53
E0646,48,47,52,65,51,263,53
E3325,43,72,53,40,55,263,53
E9133,40,58,57,46,61,262,53
E4332,44,47,52,66,53,262,53
E8084,41,41,44,52,84,262,53
E4599,41,58,41,70,51,261,53
E7729,46,46,42,79,48,261,53
E5071,70,54,44,49,42,259,52
E4462,60,45,61,45,48,259,52
E1642,45,46,53,59,55,258,52
E2778,42,48,73,48,47,258,52
E1237,48,45,60,63,42,258,52
E7387,49,76,42,41,49,257,52
E2985,57,43,40,74,43,257,52
E0842,62,47,43,41,64,257,52
E2670,63,52,43,49,49,256,52
E7530,44,53,64,43,52,256,52
E6314,44,49,60,52,51,256,52
E5749,50,56,52,42,56,256,52
E9483,53,55,45,53,49,255,51
E7914,77,44,40,52,42,255,51
E2220,46,56,53,46,54,255,51
E1257,44,40,54,56,59,253,51
E0290,43,43,41,55,71,253,51
E4931,42,52,48,61,49,252,51
E0156,42,61,45,43,61,252,51
E7898,50,58,55,42,46,251,51
E5406,43,50,45,57,56,251,51
E1813,44,50,62,52,43,251,51
E7465,53,46,44,42,66,251,51
E9276,41,66,47,46,51,251,51
E2614,43,71,43,49,45,251,51
E1572,51,55,47,44,54,251,51
E6226,56,40,62,46,46,250,50
E5969,78,43,42,40,46,249,50
E3140,41,58,66,41,43,249,50
E1797,50,47,54,45,53,249,50
E1054,54,52,47,48,48,249,50
E9019,48,47,42,59,53,249,50
E7398,45,40,45,40,79,249,50
E1770,81,40,41,46,40,248,50
E6370,44,42,42,55,65,248,50
E3579,43,45,57,40,62,247,50
E4602,55,42,55,42,53,247,50
E5310,42,42,55,64,43,246,50
E2697,40,57,41,55,53,246,50
E1603,41,74,43,46,42,246,50
E3461,49,46,49,46,56,246,50
E8846,48,49,41,61,47,246,50
E5183,46,40,48,51,59,244,49
E7902,53,51,57,42,41,244,49
E6806,49,60,40,49,43,241,49
E1411,45,58,45,50,40,238,48
E2616,43,49,45,44,56,237,48
E5032,49,56,42,45,44,236,48
E4526,50,50,43,40,52,235,47
E7566,41,40,72,41,41,235,47
E4363,45,55,40,46,48,234,47
